그렇기때문에|그리하여,그리고,이리하여,그렇게하여
단련|연마
일정한|꾸준한,균등한,불변한
쓸수록|사용할수록,쓰면쓸수록,
좋아|괜찮아,나쁘지않아,괜춚아.괜차나
최근|요즘,지금,현재
전문의|전문가
습관|연습,버릇
자신|본인
점검|검토
1주일|일주일,한주일
처음|첨
식당|음식점
식사|섭취
음악|노래
항상|항시,항상그랬듯
새로운|새롭게
최신|최근
유행어|은어
생각|상념,고민
않는다면|않다면
봐야|보아야
라이프사이클|생활패턴
먹어주는것이|먹는것이
신경을쓰시고|관심을가지시고,신경을써주시고,신경을쓰셔서
평소습관처럼|평상시습관처럼,평소하던것처럼
중요합니다|중요하다고생각합니다
가능하다는|할수있다는,가능한
그래서인지|그렇기때문인지
기하급수적|천문학적
끝날때까지|마칠때까지
글|포스팅
필자|쓴이
어떠한|어떤
어떤|어떠한
습니다|어요
또|또한
누굴|누구를
지극히|극히,더할나위없이
매력|마력
많이들|많이
말씀하십니다|말하십니다.,말합니다.
마력|매력
가장|제일
그중에서도|그중에도,그중에서
가장|무척,제일,매우
아시는|아는
해보자면|해보면,하자면
담당관리자|담당자
대학학자금|대학교학자금
따로만들어|추가로만들어
만기수익율|만기수익률,만료수익율,만료수익률
만들어지면|형성되면
방패막이가|막아주는,보호해주는
별생각없이|아무생각없이
불가능해도|안된다해도
상품들보다|상품들에비해
설립하는것|수립하는것
시작할지도|시작해야할지도
신입직장인|신입사원,사회초년생
안녕하세요|반갑습니다
알아두어야|파악해두어야
일반적으로|보편적으로
있을거라고|있겠다라고
자녀교육비|아이들교육비
저장하도록|보관하도록
전반적으로|전체적으로
정리하자면|요약하자면
주의하도록|조심하도록
준비하셔야|대비하셔야
지긋지긋한|짜증나는
지속적으로|계속적으로
참고하시어|참고하셔서
풍요롭지는|여유롭지는
누구에게는|누구에개는,누군가에게는,누군가에개는
장기적으로|길게
포트폴리오|portfolio
때문입니다|때문이라합니다
현금 결제|현금으로 결제
늘어나면서|늘면서,늘어나고있으면서
효율적으로|효과적으로
현금서비스|현금으로 하는 서비스
해야 하는|해야만 하게되는
best|최고,Best,BEST
경우이며|상황이며
고려하며|생각하며
고려해야|고심해야
괜찮은건|좋은건
그러므로|그러니
그로인해|그리하여
그에따른|그에따라
나중에는|훗날에는
너므너므|정말정말
노력하는|끈기있는
높여주어|높여줘서
늘어나고|많아지고
다루도록|이야기하도록
단기간에|짧은기간에
단순하게|간단하게
달성하기|이루기,이룩하기
대한민국|한국
돋보였던|돋보인
되신다면|된다면,된다고한다면,되신다고한다면
들어오는|들어오게되는,들어오려는
따라하고|흉내내고
마련하는|구축하는,구매하는,사려는
마이너스|마이나스
막막하고|막연하고
막연하게|아무렇게나
말그대로|글자그대로,말 그대로
명심해야|잊지말아야,명심 해야
미리부터|사전부터
반복하여|계속하여
발생하게|생겨나게
발생하는|발생하는
방법들을|수단들을
본인에게|자신에게
봤습니다|보았습니다
불필요한|필요없는
빨리빨리|빠르게,서둘러
사회생활|사회경험,직장생활
살펴봐야|관찰해봐야,살펴보아야
새로나온|나온지얼마안된,새롭게나온
생각하는|예상하는
생일비용|생일축하비용
섭취하는|먹어주는
세금감면|세금절약
소비량을|소모량을
소비하게|소모하게
속전속결|신속하게
순위경쟁|순위다툼,순위 경쟁
순조롭게|어렵지않게
스트레스|스트래스,stress
식이조절|식이요법
신입직원|신입사원
실시해도|실행해도
심한경우|심각한경우
써놓아야|써놔야
알아봐야|알아보아야
알짜배기|액기스,알자배기,알짜베기
어리석은|잘못된
여가활동|여가생활
여러가지|다양한
예전부터|이전부터
예전에야|예전에는
옛날처럼|예전처럼
오랜기간|장기간
오랜만에|간만에
오랜시간|긴시간,
왠만해선|왼만해서,웬만해선,어지간해선
요즘에는|최근에는,근래에는,최근엔,요즘엔,근래엔
우수하게|뛰어나게,월등하게,훌륭하게
운영방법|운용방법,경영방법
원금손실|원금손해
위해서는|위해선
의료기술|과학기술
의지력만|노력만
이라고도|이다라고
이쯤에서|요쯤에서,지금에서
일어나게|발생하게
있을수도|있을지도
작성하자|기재하자
저렴하고|싸고,가격이좋고,나쁘지않고,착하고,좋고,싸기도하고
조장하게|부추기게
좋은방법|괜찮은방법,좋았던방법
좋지않고|안좋고,좋지도않고,좋지않았고
준비하여|대비하여,예비하여,채비하여,계획하여
준비할수|대비할수,계획할수,예비할수
지속적인|계속적인
지속하기|지속적으로하기
지출통제|소비통제
처음에는|첫번째는,첫째로,우선
철저하게|완벽하게,완벽할수있게,철저히,완벽히
체계적인|계획적인,조직적인,제도적인,시스템적인
촉진시켜|자극시켜
충동구매|충동소비
투자수단|투자방법
패러다임|트랜드
평가되는|여겨지는,평가된
문의|상담
장만|새로사려고
다양하게|많은방법으로
봅니다|볼게요
한다면|하셨다면,했었다면,했다면,했었으면
방법|방식,방안,방도,수단
계획|도모,의도,준비,구상
합니다|해요
됩니다|되요
말해드릴 수|말씀해드릴 수
말해드릴수|말씀해드릴수
정확하게|퍼펙트하게,틀림없이,오차없이
중요한|막중한,중대한
특히|특별히,각별히,남달리,유달리,특히나
마련|장만
하려고|하시려고,할려고
요소|요건,요인,요지,조건
부담|짐
적당한|온당한,적절한,지당한,타당한,합당한
적당하다|온당하다,적절하다,지당하다,타당하다,합당하다
있어요|있습니다,있다!!!!:),있을 수 있다!
좋을수도|나쁘지않을수도
아셔야|알아야,알고있어야
알고있어야|아셔야,알아야
나쁘지않을수도|좋을수도
좋지않을수도|나쁠수도
목적|의도,취지,생각
알맞게|적절하게,적당하게,적합하게
적당한|알맞은,적합한,적절한
결혼|혼인
할 수 있죠|할 수 있습니다,할 수 있다
좋을겁니다|좋습니다,좋을 수 있습니다.
좋을|나쁘지않을
좋다|나쁘지않다.
금액|비용,가격,요금
조건|전제,자격,요건
고민|생각,갈등,번뇌,걱정,고심
대부분이|많은사람들이,십중팔구,대개,대다수
대부분|많은사람들,십중팔구,대개,대다수
특정한|특별히 지정한
한번이라도|한번쯤은,한번은,한번만은
들어있지만|들어가있지만
평소|평상시,평소에도
선택하는게|고려하는게,고민하는게,갈등하는게,고심하는게
고려|생각,고민,갈등
ㅎ|ㅋ
ㅋ|ㅎ
빠르게|신속하게,빨리,조속히,즉시,곧,속히
적정|적당한,적절한
적당한|적절한,적정
예전에는|옛날에는,전에는,과거에는
그곳|거기
스마트폰|핸드폰,휴대폰
일반적인|보편적인,상식적인
일반적|보편적,상식적
본인|자기자신,자신
찾아보는|알아보는
바가지|덤탱이,눈탱이
스스로|자기자신이,자신의 힘으로,손수
신뢰|신임,신망
인터넷|internet
알아보고|찾아보고,검색해보고
이용해|활용해
계시는게|있는게
직접|손수,몸소
쉬워|어렵지않아
쉽다|어렵지않다
어렵다|쉽지않다
금전|재산,돈
회사|기업,사업자
절세|세금절약
하고요|하구요,하고,하구
많거나|적지않거나,어마어마하거나,상당하거나
요금|금액,가격,비용
출중한|대단한,뛰어난,탁월한,특출난
대단한|뛰어난,탁월한,출중한,특출난
뛰어난|대단한,탁월한,출중한,특출난
자기의|본인의,자기자신의
민감한|예민한
평범한|무난한
모든|많은,대부분
유리한|유익한,이로운
그래서|그렇기때문에,그리하여,그러므로
그렇기때문에|그리하여,그러므로,그래서
현재|지금
아닌데요|아닙니다.
했는데요|했습니다.,했었습니다.했었는데요
좋은점|장점
장점|좋은점
단점|나쁜점
나쁜점|단점
최고로|제일 먼저,우선적으로,첫번째로
첫번째로|최고로,제일먼저,우선적으로,
하신다면|하려고한다면,하려면
초창기|초반,처음
투자금|초기비용
전액|모든금액,모든비용
세금감면|절세,세금절약
지불해야|내야
있기에|있기 때문에,있어
있습니다|있어요
많은 비용|큰 금액,많은 금액
매우|엄청,많이
고급스러운|고급진
하게 되면|하게 된다면,한다면,한다고 하면
전부다|전부,모든게
적은|많지 않은
그리고|또한,그리하여,또
리스료|리스비용,리스금액
변경할|바꿀
재산|자산
없습니다|없어요
있습니다|있어요
한가지|하나,한개
좋은|나쁘지않은
자산|자기재산,재산
말씀드렸습니다|말씀드렸는데요
말씀드렸는데요|말씀드렸습니다
모쪼록|아무쪼록
오늘도|오늘하루도
정말|진짜
고생|수고
수고|고생
다음에도|앞으로 계속해서
찾아오겠습니다|찾아뵙도록하겠습니다.,찾아오도록하겠습니다.
목적|사용용도
유익한|알찬,꽉찬,좋은
벤츠|benz
BMW|비머
아우디|AUDI
볼보|volvo
저렴한|합리적인,싸고좋은,비싸지않은
원래는|기존에는
금액적인|금전적인,비용적인,가격적인
복잡하게|어렵게,이해하기힘들게,쉽지않게
결정|선택,초이스
상당히|많은,엄청난,상당히 많은
가격비교|견적비교,금액비교
생각했더니|생각해봤더니
핸드폰|스마트폰,휴대폰
있겠습니다|있습니다.
저렴하게|적당하게,비싸지않게
사용하실|이용하실
사용하다|이용하다
사용|이용
용도|상황,목적
상태|컨디션
아직까지|현재까지,지금까지,여태껏,여지껏,이제껏
전혀|완전
당장|지금바로,바로
금액|비용,금전,가격
비용|금액,금전,가격
금전|비용,금액,가격
가격|금전,비용,금액
과도한|지나친,무리한,심한
급등|폭등
했는데요|했었는데요,했었습니다.,했습니다.
했습니다|했었습니다
원인|요인
요인|원인
요구|청,요청
엄청난|과도한,무리한,심한
많은|수 많은,수 없이 많은
너도 나도|누구든지,많은 사람이
뚜렷하게|정확하게,분명하게,또렷하게
이지요|입니다.
이미|진즉에,진즉,진작,앞서
그때에도|그날에도
올해|이번해,이번년에도,올해에도,이번해에도
망설이다|고민하다,어물쩡대다,결정하지못하다
적절한|적당한,적합한
하며|하고,하면서
지요.|습니다.
습니다|지요
보다 안전한|안정적인,위험하지 않은,위험이 적은,리스크가 적은
안정적인|위험하지 않은,위험이 적은,리스크가 적은
미리|먼저,앞서,미리미리
전략적|계획적
인하여|인해,의거해
는데요|습니다.
습니다|는데요
하여|해
하지만|그렇지만,그러나
결론적|결과적
연속|지속
간단|간략
통해서|통해,통하여
막대한|거대한,막중한,큰,거대한
몇번|여러번
예를들어서|예를들어
예를들어|예를들어서
예를들면|예를들자면
예를들어보면|예로
이며|이고
무조건|무조건적인
습니다|어요.
어요|습니다.
입니다|에요.
흔히들|흔히
하면|한다면
답은|정답은
정답은|답은
어마어마|어마,많은,엄청많은,엄청난
혹은|또는,또한
또한|혹은,또는
또는|혹은,또한
만약|만약에,만일,만에하나
원래대로|본래대로
첫판|첫번째판
꾸준히|꾸준하게,한결같이,끈임없이
아무리|제아무리,아무려나,암만,아무려면
무더운|완전 더운,폭염
계시죠|있죠
이번|요번
나선다.|나섰다.
완전히|완전한,완전하게
아니다.|아닙니다.
렌트나라코리아|렌트
렌코|리스렌트업체
렌트나라 코리아|렌트리스견적비교업체
친구|동무,동료
절대로|다시는,다신
하여튼|암튼
절대로|두번다시는,두번다신
한번씩|한번은
ㅠ|ㅜ
맘|마음
드뎌|드디어
안녕하세요|반갑습니다
오늘|금일
반갑네용|안녕하세요,어서오세요
큰언니|작은언니
아기|아가
가끔|간혹
오랫만에|오랜만에,오래간만에
동네|근처
포스팅|글
블랙박스|블박
블박|블랙박스
넓은|큰
큰|넓은
썬팅|틴팅
선팅|틴팅
께요|겠습니다.
안녕하세용|어서오세요,안녕하세요,안녕하세유,반갑습니다
커뮤니티|카페,홈페이지
정보|지식
차량|자동차,차
매일|하루,언제나
퇴근|칼퇴
습니다|어요
그렇다고|그렇다고해서
세상|세계,만천하,세간,사회,천지,시대
세계|만천하,세간,사회,천지,시대,세상
만천하|세간,사회,천지,시대,세상,세계
세간|사회,천지,시대,세상,세계,만천하
사회|천지,시대,세상,세계,만천하,세간
천지|시대,세상,세계,만천하,세간,사회
시대|세상,세계,만천하,세간,사회,천지
일생|평생
평생|일생
축복|행복,복,행복한 복,큰 복
행복|복,행복한 복,축복,큰 복
행복한 복|축복,큰 복,행복,복
축복|큰 복,행복,복,행복한 복
큰 복|축복,행복,복,행복한 복
귀여운|예쁜,사랑스러운,깜찍한,기특한,애교스러운
예쁜|사랑스러운,깜찍한,기특한,애교스러운,귀여운
사랑스러운|깜찍한,기특한,애교스러운,귀여운,예쁜
깜찍한|기특한,애교스러운,귀여운,예쁜,사랑스러운
기특한|애교스러운,귀여운,예쁜,사랑스러운,깜찍한
애교스러운|귀여운,예쁜,사랑스러운,깜찍한,기특한
귀여운|예쁜,사랑스러운,깜찍한,기특한,애교스러운
자수성가|적수성가,자성일가
적수성가|적수기가,자성일가
자성일가|자성일가,적수성가
내준|배풀어준,제공해준,건네준
배풀어준|제공해준,건네준,내준
제공해준|건네준,내준,배풀어준
건네준|내준,배풀어준,제공해준
시간|기간,타임
타임|시간,기간
동안|시간,기간
기간|시간,기간
불과|겨우,고작,기껏해야,고작해야
겨우|고작,기껏해야,고작해야,불과
고작|기껏해야,고작해야,불과,겨우
기껏해야|고작해야,불과,겨우,고작
고작해야|불과,겨우,고작,기껏해야
그 전에|전에,이전에,과거에
과거에|그 전에,전에,이전에
이전에|과거에,그 전에,전에
전에|이전에,과거에,그 전에
사두고|장만해두고,구입하고,사들여,매입해
장만해두고|구입하고,사들여,매입해,사두고
구입하고|사들여,매입해,사두고,장만해두고
사들여|매입해,사두고,장만해두고,구입하고
매입해|사두고,장만해두고,사들여,구입하고
가격|값,금액,가액,액수
기준|목표,표준,규격,기준점
목표|표준,규격,기준점,기준
표준|규격,기준점,기준,목표
규격|기준점,기준,목표,표준
기준점|기준,목표,표준,규격
지금|이제,현재,방금,당장,이때
이제|현재,방금,당장,이때,지금
현재|방금,당장,이때,지금,이제
방금|당장,이때,지금,이제,현재
당장|이때,지금,이제,현재,현재
이때|지금,이제,현재,현재,당장
이미|벌써,앞서
벌써|앞서,이미
앞서|이미,벌써
조금|약간,쪼끔,조끔,쪼끔,다소,얼마간,살짝
약간|쪼끔,조끔,쪼끔,다소,얼마간,살짝,조금
쪼끔|조끔,쪼끔,다소,얼마간,살짝,조금,약간
조끔|쪼끔,다소,얼마간,살짝,조금,약간,쪼끔
쪼끔|다소,얼마간,살짝,조금,약간,쪼끔,조끔
다소|얼마간,살짝,조금,약간,쪼끔,조끔,쪼끔
얼마간|살짝,조금,약간,쪼끔,조끔,쪼끔,다소
살짝|조금,약간,쪼끔,조끔,쪼끔,다소,얼마간
통이|씀씀이
씀씀이|통이
크다|굵다,커다랗다,거대하다,큼직하다,광활하다,우람하다,웅장하다,방대하다
굵다|커다랗다,거대하다,큼직하다,광활하다,우람하다,웅장하다,방대하다,크다
커다랗다|거대하다,큼직하다,광활하다,우람하다,웅장하다,방대하다,크다,굵다
거대하다|큼직하다,광활하다,우람하다,웅장하다,방대하다,크다,굵다,커다랗다
큼직하다|광활하다,우람하다,웅장하다,방대하다,크다,굵다,커다랗다,거대하다
광활하다|우람하다,웅장하다,방대하다,크다,굵다,커다랗다,거대하다,큼직하다
우람하다|웅장하다,방대하다,크다,굵다,커다랗다,거대하다,큼직하다,광활하다
웅장하다|방대하다,크다,굵다,커다랗다,거대하다,큼직하다,광활하다,우람하다
방대하다|크다,굵다,커다랗다,거대하다,큼직하다,광활하다,우람하다,웅장하다
저축|저금,저장,비축,예금,적립
저금|저장,비축,예금,적립,저축
저장|비축,예금,적립,저축,저금
비축|예금,적립,저축,저금,저장
예금|적립,저축,저금,저장,비축
적립|저축,저금,저장,비축,예금
가치|값어치
값어치|가치
국내|내국,국중
내국|국중,국내
재벌|부자,재산가,재력가
부자|재산가,재력가,재벌
재산가|재력가,재벌,부자
재력가|재벌,부자,재산가
순위|지위,위치,서열,랭킹,차례
지위|위치,서열,랭킹,차례,순위
위치|서열,랭킹,차례,순위,지위
서열|랭킹,차례,순위,지위,위치
랭킹|차례,순위,지위,위치,서열
차례|순위,지위,위치,서열,랭킹
재산|재물
재물|재산
감축|축하
축하|감축
천국|하늘
하늘|천국
희망|꿈,바램,기대,소원,소망
꿈|바램,기대,소원,소망,희망
바램|기대,소원,소망,희망,꿈
기대|소원,소망,희망,꿈,바램
소원|소망,희망,꿈,바램,기대
소망|희망,꿈,바램,기대,소원
희망|꿈,바램,기대,소원,소망
새로운|신선한,참신한,신기로운
신선한|참신한,신기로운,새로운
참신한|신기로운,새로운,신선한
신기로운|새로운,신선한,참신한
시대|때,시기,세기
시기|세기,시대,때
세기|시대,때,시기
포대|자루,가방,포대
자루|가방,포대,큰 가방
가방|포대,큰 가방,자루
포대|큰 가방,자루,가방
큰 가방|자루,가방,가방
담아|넣어
넣어|담아
훨씬|월등히,한결,월등하게,한층
월등히|한결,월등하게,한층,훨씬
한결|월등하게,한층,훨씬,월등히
월등하게|한층,훨씬,월등히,한결
한층|훨씬,월등히,한결,월등하게
빠르고|급하고,잽싸고,재빠르고,날래고,민첩하고,쏜살같고,날쌔고
급하고|잽싸고,재빠르고,날래고,민첩하고,쏜살같고,날쌔고,빠르고
잽싸고|재빠르고,날래고,민첩하고,쏜살같고,날쌔고,빠르고,급하고
재빠르고|날래고,민첩하고,쏜살같고,날쌔고,빠르고,급하고,잽싸고
날래고|민첩하고,쏜살같고,날쌔고,빠르고,급하고,잽싸고,재빠르고
민첩하고|쏜살같고,날쌔고,빠르고,급하고,잽싸고,재빠르고,날래고
쏜살같고|날쌔고,빠르고,급하고,잽싸고,재빠르고,날래고,민첩하고
날쌔고|빠르고,급하고,잽싸고,재빠르고,날래고,민첩하고,쏜살같고
정확|똑똑,분명,확실,명확
똑똑|분명,확실,명확,정확
분명|확실,명확,정확,똑똑
확실|명확,정확,똑똑,분명
명확|정확,똑똑,분명,확실
번개|벼락,섬광,번갯불
벼락|섬광,번갯불,번개
섬광|번갯불,번개,번개
번갯불|번개,번개,섬광
또한|역시,더욱이,더군더나,더구나
역시|더욱이,더군더나,더구나,또한
더욱이|더군더나,더구나,또한,역시
더군더나|더구나,또한,역시,더욱이
더구나|또한,역시,더욱이,더군더나
언제|이제,어느날
이제|지금,인제
예전|오래전,지난 날,과거,옛날
오래전|지난 날,과거,옛날,예전
과거|옛날,예전,지난 날,오래전
옛날|예전,지난 날,오래전,과거
지난 날|예전,오래전,과거,옛날
오래전|언제,이제,예전,과거
여러분|모두들,다들
모두들|다들,여러분
다들|여러분,모두들
사실|실제,진짜,실화
실제|진짜,실화,사실
진짜|실화,사실,실제
실화|사실,실제,진짜
현재|지금,시방,방금,당장,이제
지금|시방,방금,당장,이제,현재
시방|방금,당장,이제,현재,지금
방금|당장,이제,현재,지금,시방
당장|이제,현재,지금,시방,방금
이제|현재,지금,시방,방금,당장
벌어진|생긴,발생된,일어난,진행된,터진
생긴|발생된,일어난,진행된,터진
발생된|일어난,진행된,터진,생긴
일어난|진행된,터진,생긴,발생된
진행된|터진,생긴,발생된,일어난
터진|생긴,발생된,일어난,진행된
알았더라면|알았다면,알고있었다면,알았으면,알게됬다면
알았다면|알고있었다면,알았으면,알게됬다면
알고있었다면|알았으면,알게됬다면,알았다면
알았으면|알게됬다면,알았다면,알고있었다면
알게됬다면|알았다면,알고있었다면,알았으면
알았다면|알고있었다면,알았으면,알게됬다면
그리고|또는
또는|그리고
인간|사람
사람|인간
구매|구입,매수,매입
구입|매수,매입,구매
매수|매입,구매,구매
매입|구매,구매,매수
다음|뒤,후,사후
도움|보탬
보탬|도움
보탬|도움
도움|보탬
직접|손수,몸소
손수|몸소,직접
몸소|직접,손수
이전|이전,전
이전|전,예전
예전|이전,전
늘고|불어나고,커지고,퍼지고,많아지고,증가하고,급증하고
불어나고|커지고,퍼지고,많아지고,증가하고,급증하고,늘고
커지고|퍼지고,많아지고,증가하고,급증하고,늘고,불어나고
퍼지고|많아지고,증가하고,급증하고,늘고,불어나고,커지고
많아지고|증가하고,급증하고,늘고,불어나고,커지고,퍼지고
증가하고|급증하고,늘고,불어나고,커지고,퍼지고,많아지고
급증하고|늘고,불어나고,커지고,퍼지고,많아지고,증가하고
많고|방대하고,가득하고,넘치고,무수하고,수룩하고,수도없고,어마하고,풍부하고,풍요하고,상당하고
방대하고|가득하고,넘치고,무수하고,수룩하고,수도없고,어마하고,풍부하고,풍요하고,상당하고,많고
가득하고|넘치고,무수하고,수룩하고,수도없고,어마하고,풍부하고,풍요하고,상당하고,많고,방대하고
넘치고|무수하고,수룩하고,수도없고,어마하고,풍부하고,풍요하고,상당하고,많고,방대하고,가득하고
무수하고|수룩하고,수도없고,어마하고,풍부하고,풍요하고,상당하고,많고,방대하고,가득하고,넘치고
수룩하고|수도없고,어마하고,풍부하고,풍요하고,상당하고,많고,방대하고,가득하고,넘치고,무수하고
수도없고|어마하고,풍부하고,풍요하고,상당하고,많고,방대하고,가득하고,넘치고,무수하고,수룩하고
어마하고|풍부하고,풍요하고,상당하고,많고,방대하고,가득하고,넘치고,무수하고,수룩하고,수도없고
풍부하고|풍요하고,상당하고,많고,방대하고,가득하고,넘치고,무수하고,수룩하고,수도없고,어마하고
풍요하고|상당하고,많고,방대하고,가득하고,넘치고,무수하고,수룩하고,수도없고,어마하고,풍부하고
상당하고|많고,방대하고,가득하고,넘치고,무수하고,수룩하고,수도없고,어마하고,풍부하고,풍요하고
각종|갖가지,가지가지,가지각색,각색,각양각색,각가지,여러가지
갖가지|가지가지,가지각색,각색,각양각색,각가지,각종,여러가지
가지가지|가지각색,각색,각양각색,각가지,각종,갖가지,여러가지
가지각색|각색,각양각색,각가지,각종,갖가지,가지가지,여러가지
각색|각양각색,각가지,각종,갖가지,가지가지,가지각색,여러가지
각양각색|각가지,각종,갖가지,가지가지,가지각색,각색,여러가지
여러가지|각가지,각종,갖가지,가지가지,가지각색,각색,각양각색
각가지|각종,갖가지,가지가지,가지각색,각색,각양각색,여러가지
갖 가지|가지 가지,가지 각색,각색,각양 각색,각가지,각종,여러 가지
가지 가지|가지 각색,각색,각양 각색,각가지,각종,갖 가지,여러 가지
가지 각색|각색,각양 각색,각가지,각종,갖 가지,가지 가지,여러 가지
각양 각색|각가지,각종,갖가지,가지 가지,가지 각색,각색,여러 가지
여러 가지|각가지,각종,갖가지,가지 가지,가지 각색,각색,각양 각색
세금|조세,세,공세
조세|세,공세,조세
대한|향한,마주한,대면한,접한,관한
향한|마주한,대면한,접한,관한,대한
마주한|대면한,접한,관한,대한,향한
대면한|접한,관한,대한,향한,마주한
접한|관한,대한,향한,마주한,대면한
관한|대한,향한,마주한,대면한,접한
더해지게|많아지게,더 많게
더 많게|많아지게,더해지게
많아지게|더 많게,더해지게
이외에|그밖에,외적으로
그밖에|외적으로,이외에
외적으로|이외에,그밖에
외적으로|이 외에,그 밖에
그 밖에|외적으로,이 외에
이 외에|그 밖에,외적으로
부수적인|부가적인,이차적인,부차적인
부가적인|이차적인,부차적인,부수적인
이차적인|부차적인,부수적인,부가적인
부차적인|부수적인,부가적인,이차적인
경비|경비,비용
자금|경비,비용
비용|자금,경비
아끼|절약하,사리,축소하
절약하|사리,축소하,아끼
사리|축소하,아끼,절약하
축소하|아끼,절약하,사리
절약하|사리,축소하,아끼
사리|축소하,아끼,절약하
관련|관련성,상관,연결,연관,연관성,관계성
관련성|상관,연결,연관,연관성,관계성,관련
상관|연결,연관,연관성,관계성,관련,관련성
연결|연관,연관성,관계성,관련,관련성,상관
연관|연관성,관계성,관련,관련성,상관,연결
연관성|관계성,관련,관련성,상관,연결,연관
관계성|관련,관련성,상관,연결,연관,연관성
풀이|설명,이해,해설,해석
설명|이해,해설,해석,풀이
이해|해석,풀이
해설|해석,풀이,설명,이해
해석|풀이,설명,이해,해설
오늘|금일,본 일,오늘날
금일|본 일,오늘날,오늘
본 일|오늘날,오늘,금일
오늘날|오늘,금일,본 일
수법|방법,방식,방안,방편,전술
전술|수법,방법,방식,방안,방편
방편|전술,수법,방법,방식,방안
방안|방편,전술,수법,방법,방식
방식|방안,방편,전술,수법,방법
방법|방식,방안,방편,전술,수법
대해|향하여,마주하여,대면하여,접하여,관하여
향하여|마주하여,대면하여,접하여,관하여,대해
마주하여|대면하여,접하여,관하여,대해,향하여
대면하여|접하여,관하여,대해,향하여,마주하여
접하여|관하여,대해,향하여,마주하여,대면하여
관하여|대해,향하여,마주하여,대면하여,접하여
알아|맞춰,살펴,조사해,확인해
맞춰|살펴,조사해,확인해,알아
살펴|조사해,확인해,알아,맞춰
조사해|확인해,알아,맞춰,살펴
확인해|알아,맞춰,살펴,조사해
통해|교류되어,통달하여,거쳐,연결하여
대부분|대다수,다수,대게,크게
크게|대부분,대다수,다수,대게
대게|크게,대부분,대다수,다수
다수|대게,크게,대부분,대다수
대다수|다수,대게,크게,대부분
수수료|커미션,마진료
커미션|마진료,수수료
마진료|수수료,커미션
절약|절감
절감|절약
목적|뜻,대상,타깃
대상|타깃,목적,뜻
타깃|목적,뜻,대상
가지고|지니고,취하고,소지하고,소유하고,보유하고
지니고|취하고,소지하고,소유하고,보유하고,가지고
취하고|소지하고,소유하고,보유하고,가지고,지니고
소지하|소유하,보유하,가지,지니,취하고
보유하|가지,지니,취하고,소지하,소유하
소유하|보유하,가지,지니,취하고,소지하
주택|집,거택,자택
비용|자금,돈,경비
경비|자금,비용,돈
자금|비용,돈,경비
회복|극복,복구,만회
극복|복구,만회,회복
복구|만회,회복,극복
만회|회복,극복,복구
큰|커다란,거대한,큼직한,웅장한,방대한,크나큰
커다란|거대한,큼직한,웅장한,방대한,크나큰,큰
거대한|큼직한,웅장한,방대한,크나큰,큰,커다란
큼직한|웅장한,방대한,크나큰,큰,커다란,거대한
웅장한|방대한,크나큰,큰,커다란,거대한,큼직한
크나큰|큰,커다란,거대한,큼직한,웅장한,방대한
방대한|크나큰,큰,커다란,거대한,큼직한,웅장한
상황|모양,상태,사태,판국,정황,형세
모양|상태,사태,판국,정황,형세,상황
상태|사태,판국,정황,형세,상황,모양
사태|판국,정황,형세,상황,모양,상태
판국|정황,형세,상황,모양,상태,사태
정황|형세,상황,모양,상태,사태,판국
형세|상황,모양,상태,사태,판국,정황
목돈|큰돈,거금
큰돈|거금,목돈
거금|목돈,큰돈
들어갈|들어가는,사용되는,쓰이는
많다|가득하다,수두룩하다,크다,넘친다,풍족하다,굉장하다
가득하다|수두룩하다,크다,넘친다,풍족하다,굉장하다,많다
수두룩하다|크다,넘친다,풍족하다,굉장하다,많다,가득하다
크다|넘친다,풍족하다,굉장하다,많다,가득하다,수두룩하다
넘친다|풍족하다,굉장하다,많다,가득하다,수두룩하다,크다
풍족하다|굉장하다,많다,가득하다,수두룩하다,크다,넘친다
굉장하다|많다,가득하다,수두룩하다,크다,넘친다,풍족하다
지불|지출,지급
지급|지불,지출
지출|지급,지불
줄여|축소해,압축해,감소해,단축해,절감해,삭감하여,절감하여,감소하여,압축하여,축소하여
축소해|압축해,감소해,단축해,절감해,삭감하여,절감하여,감소하여,압축하여,축소하여,줄여
압축해|감소해,단축해,절감해,삭감하여,절감하여,감소하여,압축하여,축소하여,줄여,축소해
감소해|단축해,절감해,삭감하여,절감하여,감소하여,압축하여,축소하여,줄여,축소해,압축해
단축해|절감해,삭감하여,절감하여,감소하여,압축하여,축소하여,줄여,축소해,압축해,감소해
절감해|삭감하여,절감하여,감소하여,압축하여,축소하여,줄여,축소해,압축해,감소해,단축해
삭감하여|절감하여,감소하여,압축하여,축소하여,줄여,축소해,압축해,감소해,단축해,절감해
절감하여|감소하여,압축하여,축소하여,줄여,축소해,압축해,감소해,단축해,절감해,삭감하여
감소하여|압축하여,축소하여,줄여,축소해,압축해,감소해,단축해,절감해,삭감하여,절감하여
압축하여|축소하여,줄여,축소해,압축해,감소해,단축해,절감해,삭감하여,절감하여,감소하여
축소하여|줄여,축소해,압축해,감소해,단축해,절감해,삭감하여,절감하여,감소하여,압축하여
연합|연맹,결합,통합
연맹|결합,통합,연합
결합|통합,연합,연맹
통합|연합,연맹,결합
방문자|방문객
방문객|방문자
사용되는|들어가는,쓰이는,이용되는,적용되는
들어가는|쓰이는,이용되는,적용되는,사용되는
쓰이는|이용되는,적용되는,사용되는,들어가는
이용되는|적용되는,사용되는,들어가는,쓰이는
적용되는|사용되는,들어가는,쓰이는,이용되는
수집|모집
모집|수집
데이터|자료,정보
자료|정보,데이터
정보|데이터,자료
제공|공급,보급,부여,조달,공유
공급|보급,부여,조달,공유,제공
보급|부여,조달,공유,제공,공급
부여|조달,공유,제공,공급,보급
조달|공유,제공,공급,보급,부여
공유|제공,공급,보급,부여,조달
규제|제한,제약,규정
제한|제약,규정,규제
제약|규정,규제,제한
규정|규제,제한,제약
대부분|다수,대게,크게,대다수
다수|대게,크게,대부분,대다수
대게|크게,대부분,대다수,다수
크게|대부분,대다수,다수,대게
경우|경위
경위|경우
이런|그런,이 처럼,이 같은
이러한|이 같은,이 처럼,이런
이 같은|이 처럼,이러한,이런
이 처럼|이러한,이 같은,이런
법규|규칙,법칙,제도,법률
규칙|법칙,제도,법률,법규
법칙|제도,법률,법규,규칙
제도|법률,법규,규칙,법칙
법률|법규,규칙,법칙,제도
사용자|이용자
이용자|사용자
동의|동조,합의,허락,승인
동조|합의,허락,승인,동의
합의|허락,승인,동의,동조
허락|승인,동의,동조,합의
승인|동의,동조,합의,허락
얻도록|구하도록,취하도록,획득하도록,취득하도록,가지도록
구하도록|취하도록,획득하도록,취득하도록,가지도록,얻도록
취하도록|획득하도록,취득하도록,가지도록,얻도록,구하도록
획득하도록|취득하도록,가지도록,얻도록,구하도록,취하도록
취득하도록|가지도록,얻도록,구하도록,취하도록,획득하도록
가지도록|얻도록,구하도록,취하도록,획득하도록,취득하도록
요구|청구,주문,요청
청구|주문,요청,요구
주문|요청,요구,청구
요청|요구,청구,주문
준수|엄수,검수
엄수|검수,준수
검수|준수,엄수
특정|특수
특수|특정
당신|귀하
귀하|당신
사용하며|들어가며,쓰이며,이용되며,적용되며
들어가며|쓰이며,이용되며,적용되며,사용하며
쓰이며|이용되며,적용되며,사용하며,들어가며
이용되며|적용되며,사용하며,들어가며,쓰이며
적용되며|사용하며,들어가며,쓰이며,이용되며
사용을|이용을,활용을,실용을
이용을|활용을,실용을,적용을
활용을|실용을,적용을,이용을
실용을|적용을,이용을,활용을
알리는|말하는,고하는,포고하는,안내하는
말하는|고하는,포고하는,안내하는,알리는
고하는|포고하는,안내하는,알리는,말하는
포고하는|안내하는,알리는,말하는,고하는
안내하는|알리는,말하는,고하는,포고하는
부가|추가,가증,부가
가증|부가,추가,가증
첨가|가증,부가,추가
추가|첨가,가증,부가
실제|사실,진짜,실화
사실|실제,진짜,실화
실제|진짜,실화,사실
진짜|실화,사실,실제
적용|사용,이용,반영,활용,운용
사용|이용,활용
이용|활용,사용
반영|활용,운용,적용,사용,이용
활용|운용,적용,사용,이용,반영
운용|적용,사용,이용,반영,활용
사명|책임,책임
책임|사명,책임
타사|다른 회사,타 회사,경쟁업체
다른 회사|타 회사,타사,경쟁업체
타 회사|타사,다른 회사,경쟁업체
경쟁업체|타 회사,타사,다른 회사
물건|상품,제조품,제작품,물품,제품
상품|제조품,제작품,물품,제품,물건
제조품|제작품,물품,제품,물건,상품
제작품|물품,제품,물건,상품,제조품
물품|제품,물건,상품,제조품,제작품
제품|물건,상품,제조품,제작품,물품
기능성|기능,성능,쓰임,작용
작용|기능성,기능,성능,쓰임
쓰임|작용,기능성,기능,성능
성능|쓰임,작용,기능성,기능
기능|성능,쓰임,작용,기능성
이용하는|사용하는
사용하는|들어가는,쓰이는,이용되는,적용되는
들어가는|쓰이는,이용되는,적용되는,사용하는
쓰이는|이용되는,적용되는,사용하는,들어가는
이용되는|적용되는,사용하는,들어가는,쓰이는
적용되는|사용하는,들어가는,쓰이는,이용되는
적합|마땅,적당,적절,합당
마땅|적당,적절,합당,적합
적당|적절,합당,적합,마땅
적절|합당,적합,마땅,적당
합당|적합,마땅,적당,적절
포함|함유,포괄,함축
함유|포괄,함축,포함
포괄|함축,포함,함유
함축|포함,함유,포괄
비롯|포함,함유,포괄,함축
나는|제가,저는,내가
내가|나는,제가,저는
저는|내가,나는,제가
제가|저는,내가,나는
이번|이참,요번
이참|요번,이번
요번|이번,이참
기초|기본,밑바닥
바로|곧,곧장,즉시
곧장|즉시,바로,곧
즉시|바로,곧,곧장
라인|계열
계열|라인
왼쪽|좌측,왼편,왼짝,좌편
좌측|왼편,왼짝,좌편,왼쪽
왼편|왼짝,좌편,왼쪽,좌측
왼짝|좌편,왼쪽,좌측,왼편
좌편|왼쪽,좌측,왼편,왼짝
오른쪽|우측,오른편,우편,우방,오른짝 
우측|오른편,우방,오른짝 ,우면,오른쪽
오른편|우방,오른짝 ,우면,오른쪽,우측
우방|오른짝 ,우면,오른쪽,우측,오른편
오른짝|우면,오른쪽,우측,오른편,우방
우면|오른쪽,우측,오른편,우방,오른짝 
순서|차례,질서,순번,순차
차례|질서,순번,순차,순서
질서|순번,순차,순서,차례
순번|순차,순서,차례,질서
순차|순서,차례,질서,순번
이렇게|이런식의,요렇게,이러하게
이런식의|요렇게,이러하게,이렇게
요렇게|이러하게,이렇게,이런식의
이러하게|이렇게,이런식의,요렇게
쓰고|사용하고,이용하고
사용하고|이용하고,쓰고
이용하고|쓰고,사용하고
거칠|까칠
까칠|거칠
쫀득|존득,쭌득,쫄깃,졸깃
존득|쭌득,쫄깃,졸깃,쫀득
쭌득|쫄깃,졸깃,쫀득,존득
쫄깃|졸깃,쫀득,존득,쭌득
졸깃|쫀득,존득,쭌득,쫄깃
잘아시는|곧 잘아는,똑바로 아는,바로 아는
곧 잘아는|똑바로 아는,바로 아는,곧 잘아는
똑바로 아는|바로 아는,곧 잘아는,똑바로 아는
바로 아는|곧 잘아는,똑바로 아는,바로 아는
분들|님들,여러분,님들은
님들|여러분,님들은,분들
여러분|님들은,분들,님들
님들은|분들,님들,여러분
아시겠지만|알테지만,아실거지만,아시지만,알지만,알겠지만
알테지만|아실거지만,아시지만,알지만,알겠지만
아실거지만|아시지만,알지만,알겠지만,알테지만
아시지만|알지만,알겠지만,알테지만,아실거지만
알지만|알겠지만,알테지만,아실거지만,아시지만
피부|가죽,살가죽,살갖
겁나|무척,엄청,무진장,무섭게
무섭게|겁나,무척,엄청,무진장
무진장|무섭게,겁나,무척,엄청
엄청|무진장,무섭게,겁나,무척
무척|엄청,무진장,무섭게,겁나
원래|본래,본디,애당초,애초,당초
본래|본디,애당초,애초,당초,원래
본디|애당초,애초,당초,원래,본래
애당초|애초,당초,원래,본래,본디
애초|당초,원래,본래,본디,애당초
당초|원래,본래,본디,애당초,애초
남한|우리나라,대한민국,한국
한국|남한,우리나라,대한민국
대한민국|한국,남한,우리나라
우리나라|대한민국,한국,남한
가장|제일,최고
제일|최고,가장
최고|가장,제일
친숙|친,익숙,친밀,친근
익숙|친밀,친근,친숙,친
친밀|친근,친숙,친,익숙
친근|친숙,친,익숙,친밀
가입|입회,입단
입회|입단,가입
입단|가입,입회
조사|관찰,연구,검사,검열,검토,탐사,탐색,검색
관찰|연구,검사,검열,검토,탐사,탐색,검색,조사
연구|검사,검열,검토,탐사,탐색,검색,조사,관찰
검사|검열,검토,탐사,탐색,검색,조사,관찰,연구
검열|검토,탐사,탐색,검색,조사,관찰,연구,검사
검토|탐사,탐색,검색,조사,관찰,연구,검사,검열
탐사|탐색,검색,조사,관찰,연구,검사,검열,검토
탐색|검색,조사,관찰,연구,검사,검열,검토,탐사
검색|조사,관찰,연구,검사,검열,검토,탐사,탐색
전체|모두,전부,전면
모두|전부,전면,전체
전부|전면,전체,모두
전면|전체,모두,전부
이력|경력,내력,행력
경력|내력,행력,이력
내력|행력,이력,경력
행력|이력,경력,내력
정도|규모
규모|정도
삶|생활,인생,생,인생살이,세상살이
생활|인생,생,인생살이,세상살이,삶
인생|생,인생살이,세상살이,삶,생활
인생살이|세상살이,삶,생활,인생,생
세상살이|삶,생활,인생,생,인생살이
꼭|반드시,틀림없이,필히,기어코,결단코
반드시|틀림없이,필히,기어코,결단코,꼭
틀림없이|필히,기어코,결단코,꼭,반드시
필히|기어코,결단코,꼭,반드시,틀림없이
기어코|결단코,꼭,반드시,틀림없이,필히
결단코|꼭,반드시,틀림없이,필히,기어코
필요|요구,절실,요긴
요구|절실,요긴,필요
절실|요긴,필요,요구
요긴|필요,요구,절실
중요|귀중,절실,중대,중,막중,대단
귀중|절실,중대,중,막중,대단,중요
절실|중대,중,막중,대단,중요,귀중
중대|중,막중,대단,중요,귀중,절실
막중|대단,중요,귀중,절실,중대,중
대단|중요,귀중,절실,중대,중,막중
중요|귀중,절실,중대,중,막중,대단
여겨지는|여기는,여기어진
여기는|여기어진,여겨지는
여기어진|여겨지는,여기는
꼼꼼|자세,섬세,세밀,오밀조밀,철저
자세히|섬세히,세밀히,오밀조밀히,철저히,꼼꼼히,면밀히
섬세|세밀,오밀조밀,철저,꼼꼼,면밀,자세
세밀|오밀조밀,철저,꼼꼼,면밀,자세,섬세
오밀조밀|철저,꼼꼼,면밀,자세,섬세,세밀
철저|꼼꼼,면밀,자세,섬세,세밀,오밀조밀
면밀|자세,섬세,세밀,오밀조밀,철저,꼼꼼
준비|마련,대비,채비
마련|대비,채비,준비
대비|채비,준비,마련
채비|준비,마련,대비
목적|목표,의도,취지,뜻
목표|의도,취지,뜻,목적
의도|취지,뜻,목적,목표
취지|뜻,목적,목표,의도
명확|똑똑,명백,분명,확실,정확
똑똑|명백,분명,확실,정확,명확
명백|분명,확실,정확,명확,똑똑
분명|확실,정확,명확,똑똑,명백
확실|정확,명확,똑똑,명백,분명
정확|명확,똑똑,명백,분명,확실
크게|대다수,다수,대게,대부분
대다수|다수,대게,크게,대부분
다수|대게,크게,대부분,대다수
대게|크게,대부분,대다수,다수
크게|대부분,대다수,다수,대게
대부분|대다수,다수,대게,크게
구분|나뉘게,갈리게,구별,선별
나뉘게|갈리게,구별,선별,구분
갈리게|구별,선별,구분,나뉘게
구별|선별,구분,나뉘게,갈리게
선별|구분,나뉘게,갈리게,구별
마련|준비,장만,조달
준비|장만,조달,마련
장만|조달,마련,준비
조달|마련,준비,장만
사고|사건,문제,재해,불상사
사건|문제,재해,불상사
문제|재해,불상사,사고,사건
재해|불상사,사고,사건,문제
불상사|사고,사건,문제,재해
발생|초례
초례|발생
시작|스타트,스타뚜,시작,시~작
초례|발생,시작
발생|시작,초례
납부|납입,지출
납입|지출,납부
지출|납부,납입
비교|대조
대조|비교
많은|가득한,대단한,큰,넉넉한,넘치는,다양한
가득한|대단한,큰,넉넉한,넘치는,다양한,많은
대단한|큰,넉넉한,넘치는,다양한,많은,가득한
큰|넉넉한,넘치는,다양한,많은,가득한,대단한
넉넉한|넘치는,다양한,많은,가득한,대단한,큰
넘치는|다양한,많은,가득한,대단한,큰,넉넉한
다양한|많은,가득한,대단한,큰,넉넉한,넘치는
받을|얻을,수령할
얻을|수령할
수령할|얻을
만기|말료,만기일
말료|만기일,만기
만기일|만기,말료
가격|값,금액,가액
금액|가격,값,가액
적거나|부족하거나,작거나,덜하거나,근소하거나,희박하거나,경미하거나,소소하거나
부족하거나|작거나,덜하거나,근소하거나,희박하거나,경미하거나,소소하거나,적거나
작거나|덜하거나,근소하거나,희박하거나,경미하거나,소소하거나,적거나,부족하거나
덜하거나|근소하거나,희박하거나,경미하거나,소소하거나,적거나,부족하거나,작거나
근소하거나|희박하거나,경미하거나,소소하거나,적거나,부족하거나,작거나,덜하거나
희박하거나|경미하거나,소소하거나,적거나,부족하거나,작거나,덜하거나,근소하거나
경미하거나|소소하거나,적거나,부족하거나,작거나,덜하거나,근소하거나,희박하거나
소소하거나|적거나,부족하거나,작거나,덜하거나,근소하거나,희박하거나,경미하거나
부족하고|덜하고,근소하고,희박하고,경미하고,소소하고
덜하고|근소하고,희박하고,경미하고,소소하고,부족하고
근소하고|희박하고,경미하고,소소하고,부족하고,덜하고
희박하고|경미하고,소소하고,부족하고,덜하고,근소하고
경미하고|소소하고,부족하고,덜하고,근소하고,희박하고
소소하고|부족하고,덜하고,근소하고,희박하고,경미하고
부족하면|덜하면,근소하면,희박하면,경미하면,소소하면
덜하면|근소하면,희박하면,경미하면,소소하면,부족하면
근소하면|희박하면,경미하면,소소하면,부족하면,덜하면
희박하면|경미하면,소소하면,부족하면,덜하면,근소하면
경미하면|소소하면,부족하면,덜하면,근소하면,희박하면
소소하면|부족하면,덜하면,근소하면,희박하면,경미하면
대부분이|다수에,대게,크게,대다수에
다수에|대게,크게,대부분이,대다수에
크게|대부분이,대다수에,다수에,대게
대다수에|다수에,대게,크게,대부분이
이율|이득율,이자율
이득율|이자율,이율
이자율|이율,이득율
또는|내지,혹은
내지|혹은,또는
혹은|또는,내지
실적|기록,성과,성적,업적
기록|성과,성적,업적
성과|성적,업적,기록
성적|업적,기록,성과
업적|기록,성과,성적
비해|비하면,비하자면,비교하면
비하면|비하자면,비교하면
비하자면|비교하면,비하면
상대적|비교적,대조적
비교적|대조적,상대적
제한|규제,제약,규정
규제|제한,제약,규정
제한|제약,규정,규제
제약|규정,규제,제한
규정|규제,제한,제약
적을|작을,가벼울
작을|가벼울,작을
결합|결속,상합,합,연합
결속|상합,합,연합,결합
상합|합,연합,결합,결합
연합|결합,결합,상합,합
부가|추가,가증,첨가
추가|가증,첨가,부가
가증|첨가,부가,추가
첨가|부가,추가,가증
일반적|보편적,표준적,평균적
보편적|표준적,평균적,일반적
표준적|평균적,일반적,보편적
평균적|일반적,보편적,표준적
세운|내세운,앞세운
내세운|앞세운,세운
앞세운|세운,내세운
장단점|좋고나쁜,좋거나 나쁘거나,득과실
좋고나쁜|좋거나 나쁘거나,득과실,장단점
좋거나 나쁘거나|득과실,장단점,좋고나쁜
득과실|장단점,좋고나쁜,좋거나 나쁘거나
파악|이해,간파,포착,장악
이해|간파,포착,장악,파악
간파|포착,장악,파악,이해
포착|장악,파악,이해,간파
장악|파악,이해,간파,포착
종합|전반,전체,총체,복합,일괄,포괄,총괄
전반|전체,총체,복합,일괄,포괄,총괄,종합
전체|총체,복합,일괄,포괄,총괄,종합,전반
총체|복합,일괄,포괄,총괄,종합,전반,전체
복합|일괄,포괄,총괄,종합,전반,전체,총체
일괄|포괄,총괄,종합,전반,전체,총체,복합
포괄|총괄,종합,전반,전체,총체,복합,일괄
총괄|종합,전반,전체,총체,복합,일괄,포괄
감안|생각,고려,참고,참작
고려|참고,참작,감안
참고|참작,감안,고려
참작|감안,고려,참고
각각|각기,제각각,제각기
제각각|제각기,각각,각기
제각기|각각,제각각,각기
각기|제각각,제각기,각각
바람직|마땅,건전,정당
마땅|건전,정당,바람직
건전|정당,바람직,마땅
정당|바람직,마땅,건전
내게|나에게,제게,저에게
나에게|제게,저에게,내게
제게|저에게,내게,나에게
저에게|내게,나에게,제게
맞는|꼭 맞는,잘 맞는
방식|방법,수법,방안,방편,전술
방법|수법,방안,방편,전술,방식
수법|방안,방편,전술,방식,방법
방안|방편,전술,방식,방법,수법
방편|전술,방식,방법,수법,방안
전술|방식,방법,수법,방안,방편
지남|흐름,경과,지나침
흐름|경과,지나침,지남
경과|지나침,지남,흐름
지나침|지남,흐름,경과
따라|잇따라
잇따라|따라
동일|일정,동등,균등
일정|동등,균등,동일
동등|균등,동일,일정
균등|동일,일정,동등
차이|격차,오차
격차|오차,차이
오차|차이,격차
크므로|상당하므로,막대하므로,굉장하므로,대단하므로
상당하므로|막대하므로,굉장하므로,대단하므로,크므로
막대하므로|굉장하므로,대단하므로,크므로,상당하므로
굉장하므로|대단하므로,크므로,상당하므로,막대하므로
대단하므로|크므로,상당하므로,막대하므로,굉장하므로
신중|진중,신밀,친밀,치밀
진중|신밀,친밀,치밀,신중
신밀|친밀,치밀,신중,진중
친밀|치밀,신중,진중,신밀
치밀|신중,진중,신밀,친밀
선택|채택,선정
채택|선정,선택
선정|선택,채택
이전|초기,초창기
초창기|이전,초기
초기|초창기,이전
갱신|수정,변동,변경
변경|갱신,수정,변동
변동|변경,갱신,수정
및|그리고,또,또는,또한
그리고|또,또는,또한,및
또는|또한,및,그리고
또한|및,그리고,또는
연령|나이
나이|연령
증가|증첨,증대
증첨|증대,증가
증대|증가,증첨
지속|계속,연속
계속|지속,연속
연속|계속,지속
특히|워낙,유난히,남달리,특별히
워낙|유난히,남달리,특별히,유달리,유달리
유난히|남달리,특별히,유달리,워낙,특히
특별히|유달리,워낙,특히,특히,유난히
남달리|특별히,유달리,워낙,특히,유난히
유달리|워낙,특히,유난히,남달리,유난히
워낙|특히,유난히,남달리,남달리,특별히
이후|다음,향후,차후,특별히,유달리
다음|향후,차후,이후
향후|이후,다음,차후
차후|이후,다음,향후
납부|납입,지출
납입|지출,납부
지출|납부,납입
납부|납입,지출
고정|일정
일정|고정
소득|수익,이익,이득,이윤
수익|이익,이득,이윤,소득,소득
이익|이득,이윤,소득,수익,수익
이득|이윤,소득,수익,이익,이익
이윤|소득,수익,이익,이득,이득
납입|납부,지출,납부이윤
지출|납입,납부,지출
더욱|더욱더,한층더,더 더욱,한층
더욱더|한층더,더 더욱,한층,더욱,더욱
한층더|더 더욱,한층,더욱,더욱더,더욱더
더 더욱|한층,더욱,더욱더,한층더,한층더
한층|더욱,더욱더,한층더,더 더욱,더 더욱
더욱|더욱더,한층더,더 더욱,한층,한층
커질|늘어날,자랄,부풀어질,불어날,더욱
늘어날|자랄,부풀어질,불어날,커질,커질
자랄|부풀어질,불어날,커질,늘어날,늘어날
부풀어질|불어날,커질,늘어날,자랄,자랄
불어날|커질,늘어날,자랄,부풀어질,부풀어질
부담|걱정,고민
걱정|고민,부담
고민|걱정,부담
커져|늘어져,불어나져,부풀어져
늘어나|불어나,커져나
불어나|부풀어나,커져나,늘어나
부풀어져|커져,늘어나져,불어나져
유지|보존,계속,지속,관리,케어
보존|계속,지속,관리,보전,보전,유지
계속|지속,관리,보전,유지,유지,보존
지속|관리,보전,유지,보존,보존,계속
관리|보전,유지,보존,계속,케어,지속
보전|유지,보존,계속,지속,지속,관리
케어|지속,관리,보전,유지,보존,계속
어렵다|난감하다,난해하다,간고하다,힘들다,관리,보전
난감하다|난해하다,간고하다,힘들다,힘겹다,힘겹다,어렵다
난해하다|간고하다,힘들다,힘겹다,어렵다,어렵다,난감하다
간고하다|힘들다,힘겹다,어렵다,난감하다,난감하다,난해하다
힘들다|힘겹다,어렵다,난감하다,난해하다,난해하다,간고하다
힘겹다|어렵다,난감하다,난해하다,간고하다,간고하다,힘들다
이유|사유,근거
사유|근거,이유
근거|이유,사유
계약|약정,체약
약정|체약,약속
체약|약속,계약
약속|계약,약정
해지|해약,철회
해약|철회,해지
철회|해지,해약
결국|끝내
끝내|결국
보장|보증
보증|보장
받지|얻지
얻지|받지
모양|형태,모습,모양
상태|사태,판국,정황,형세,상황,모양
사태|판국,정황,형세,상황,상황,모양,상태
판국|정황,형세,상황,상황,모양,상태,사태
정황|형세,상황,상황,모양,상태,사태,판국
형세|상황,상황,모양,상태,사태,판국,정황
생길|주어질,탄생할
주어질|탄생할,생길
탄생할|생길,주어질
변경|변동,수정,경신,전환,갱신
변동|수정,경신,전환,갱신,변경
경신|전환,갱신,변경,수정
전환|갱신,변경,변동,수정,경신
갱신|변경,변동,수정,경신,전환
반드시|틀림없이,필히,기어코,결단코,꼭
틀림없이|필히,기어코,결단코,꼭,반드시,반드시
필히|기어코,결단코,꼭,반드시,반드시,틀림없이
기어코|결단코,꼭,반드시,반드시,틀림없이,필히
결단코|꼭,반드시,반드시,틀림없이,필히,기어코
꼭|반드시,반드시,틀림없이,필히,기어코,결단코
확인|검사,검토,조사,체크
검사|검토,조사,확인,체크
검토|조사,확인,검사,체크
조사|확인,검사,검토,체크
맞춰|살펴,알아
살펴|알아,맞춰
결정|결단,지정,판정,단정,확정
결단|지정,판정,단정,확정,결정
지정|판정,단정,확정,결정,결단
판정|단정,확정,결정,결단,지정
단정|확정,결정,결단,지정,판정
확정|결정,결단,지정,판정,단정
키우|기르,양육하
기르|키우,양육하
양육하|키우,기르
집사|하인
하인|집사
주위에|주변에,근처에
주변에|근처에,사방에,주위에,주변에
근처에|사방에,주위에,주위에
사방에|주위에,주변에,근처에
반려견|강아지,멍멍이
강아지|멍멍이,반려견
멍멍이|강아지,반려견
데리고|모시고,동반하고,대동하고
모시고|동반하고,대동하고,데리고
동반하고|대동하고,데리고,모시고
대동하고|데리고,모시고,동반하고
친한|가까운,사이좋은,친밀한,절친
가까운|사이좋은,친밀한,절친,친한,밀접한
사이좋은|친밀한,절친,친한,가까운
친밀한|절친,친한,가까운,사이좋은
절친|친한,가까운,사이좋은,친밀한
친구|동무,벗,동료
동무|벗,동료,친구
지인|동료,친구,동무,벗
동료|친구,동무,벗
키워|길러,양육해
길러|양육해,키워
양육해|키워,길러
먼저|우선,앞서,이 전에,전에
우선|앞서,이 전에,전에,먼저
앞서|이 전에,전에,먼저,우선
이 전에|전에,먼저,우선,앞서
전에|먼저,우선,앞서,이 전에
도와|거들어
거들어|도와
아이가|어린이가,어린아이가,어린애가
아이를|어린이를,어린아이를,어린애를
어린이를|어린아이를,어린애를,아이를
어린아이를|어린애를,아이를,어린이를
어린애를|아이를,어린이를,어린아이를
어린이|어린아이,어린애,꼬마
어린아이|어린애,꼬마,어린이
어린애|꼬마,어린이,어린아이
꼬마|어린이,어린아이,어린애
시대|시기,세기
시기|세기,시대
세기|시대,시기
곳에|위치에,장소에,자리에
위치에|장소에,자리에,곳에
장소에|자리에,곳에,위치에
자리에|곳에,위치에,장소에
곳에는|자리에는,위치에는,장소에는
자리에는|위치에는,장소에는,곳에는
위치에는|장소에는,곳에는,자리에는
장소에는|곳에는,자리에는,위치에는
곳에서는|자리에서는,위치에서는,장소에서는
자리에서는|위치에서는,장소에서는,곳에서는
위치에서는|장소에서는,곳에서는,자리에서는
장소에서는|곳에서는,자리에서는,위치에서는
곳은|자리는,위치는,장소는
자리는|위치는,장소는,곳은
위치는|장소는,곳은,자리는
장소는|곳은,자리는,위치는
당시에|그 시기에,그때,그 시절에
그 시기에|그때,그 시절에,당시에
그 시절에|당시에,그 시기에,그때
당시에|시기에,그때,시절에
시기에|그때,시절에,당시에
그때|시절에,당시에,시기에
시절에|당시에,시기에,그때
당시|시기,그때,찰나
시기|그때,찰나,당시
그때|찰나,당시,시기
찰나|당시,시기,그때
혜택|서비스,좋은점
서비스|혜택
친절|상냥,자상
상냥|자상,친절
자상|친절,상냥
안내|소개
소개|안내
기억|생각
추억|생각,기억
추천|소개
주게|드리게
드리게|주게
함께|아울러,나란히,같이
아울러|나란히,같이,함께
나란히|같이,함께,아울러
같이|함께,아울러,나란히
다양|각양각색
각양각색|다양
많이|잔뜩,상당히,풍성히,수두룩
잔뜩|상당히,풍성히,수두룩,많이
상당히|풍성히,수두룩히,많이,잔뜩이
풍성히|수두룩,많이,잔뜩,상당히
수두룩|많이,잔뜩,상당히,풍성히
때도|적에도,쩍에도,시기에도,시절에도,당시에도
적에도|쩍에도,시기에도,시절에도,당시에도,때도
쩍에도|시기에도,시절에도,당시에도,때도,적에도
시기에도|시절에도,당시에도,때도,적에도,쩍에도
시절에도|당시에도,때도,적에도,쩍에도,시기에도
당시에도|때도,적에도,쩍에도,시기에도,시절에도
한참|오랫동안,한동안,긴시간,오랜시간
오랫동안|한동안,긴시간,오랜시간,한참
한동안|긴시간,오랜시간,한참,오랫동안
긴 시간|오랜시간,한참,오랫동안,한동안
오랜시간|한참,오랫동안,한동안,긴시간
한 참|오랫동안,한 동안,긴 시간,오랜 시간
한 동안|긴 시간,오랜 시간,한 참,오랫동안
긴 시간|오랜 시간,한 참,오랫동안,한 동안
오랜 시간|한 참,오랫동안,한 동안,긴 시간
구경|감상,관람
감상|시청
관람|관광,유람
관광|유람,관람
유람|관람,관광
동물|짐승
건강|튼튼,튼실
튼튼|튼실,건강
튼실|건강,튼튼
견주|주인,주인님,강아지주인
주인|주인님
주인님|주인
마음|맘,생각,맴,뜻
생각|마음,맘,맴,뜻
사용|이용,반영,활용,운용,적용
이용|반영,활용,운용,적용,사용
반영|활용,운용,적용,사용,이용
활용|운용,적용,사용,이용,반영
운용|적용,사용,이용,반영,활용
적용|사용,이용,반영,활용,운용
자체|본체
본체|자체
끝|마지막,최종점
마지막|최종점,끝
최종점|끝,마지막
들어오|입장하,입문하
입장하|입문하,들어오
입문하|들어오,입장하
눈길|시선,이목,주목,관심
시선|이목,주목,관심,눈길
이목|주목,관심,눈길,시선
주목|관심,눈길,시선,이목
관심|눈길,시선,이목,주목
처음|난생 처음,첨,정말 처음,진짜 처음,완전 처음
설명|이해,해설,해석,풀이
이해|해설,해석,풀이,설명
해설|해석,풀이,설명,이해
해석|풀이,설명,이해,해설
풀이|설명,이해,해설,해석
알려주|가르쳐주,전해주,전달해주,안내해주
가르쳐주|전해주,전달해주,안내해주,알려주
전해주|전달해주,안내해주,알려주,가르쳐주
전달해주|안내해주,알려주,가르쳐주,전해주
안내해주|알려주,가르쳐주,전해주,전달해주
알리고|가르치고,전하고,전달하고,안내하고
가르치고|전하고,전달하고,안내하고,알리고
전하고|전달하고,안내하고,알리고,가르치고
전달하고|안내하고,알리고,가르치고,전하고
안내하고|알리고,가르치고,전하고,전달하고
택한|선택한,채택한,선정한
선택한|채택한,선정한,택한
채택한|선정한,택한,선택한
선정한|택한,선택한,채택한
말고도|외에도,밖에도
외에도|말고도,밖에도
알뜰|자세,섬세,세밀,오밀조밀,철저,꼼꼼
자세|섬세,세밀,오밀조밀,철저,꼼꼼,알뜰
섬세|세밀,오밀조밀,철저,꼼꼼,알뜰,자세
세밀|오밀조밀,철저,꼼꼼,알뜰,자세,섬세
오밀조밀|철저,꼼꼼,알뜰,자세,섬세,세밀
철저|꼼꼼,알뜰,자세,섬세,세밀,오밀조밀
맞춰|살펴,조사해,확인해,알아
살펴|조사해,확인해,알아,맞춰
조사해|확인해,알아,맞춰,살펴
확인해|알아,맞춰,살펴,조사해
알아|맞춰,살펴,조사해,확인해
체크|조사,확인,검사,검토
관절|뼈관절,뼈마디
뼈관절|뼈마디,관절
뼈마디|관절,뼈관절
살가죽|살갖
살갖|살가죽
면밀|알뜰,자세,섬세,세밀,오밀조밀,철저,꼼꼼
알뜰|자세,섬세,세밀,오밀조밀,철저,꼼꼼,면밀
자세|섬세,세밀,오밀조밀,철저,꼼꼼,면밀,알뜰
섬세|세밀,오밀조밀,철저,꼼꼼,면밀,알뜰,자세
세밀|오밀조밀,철저,꼼꼼,면밀,알뜰,자세,섬세
오밀조밀|철저,꼼꼼,면밀,알뜰,자세,섬세,세밀
철저|꼼꼼,면밀,알뜰,자세,섬세,세밀,오밀조밀
살피|확인하,검사하
확인하|검사하,살피
검사하|살피,확인하
주택|자택,가택,집
자택|가택,집,주택
가택|집,주택,자택
데려|데리고,모셔,모시고
데리고|모셔,모시고,데려
모셔|모시고,데려,데리고
모시고|데려,데리고,모셔
이렇게|이런식의,요렇게,이러하게
이런식의|요렇게,이러하게,이렇게
요렇게|이러하게,이렇게,이런식의
이러하게|이렇게,이런식의,요렇게
따로|특별히
특별히|따로
힘들이지|애쓰지,노력하지,힘쓰지
애쓰지|노력하지,힘쓰지,힘들이지
노력하지|힘쓰지,힘들이지,애쓰지
힘쓰지|힘들이지,애쓰지,노력하지
그러고|그리하고
그리하고|그러고
때도|시기에,시절에,시점에,시간에
일일이|낱낱이,세세히
낱낱이|세세히,일일이
세세히|일일이,낱낱이
같습니다|같았어요,같았고요,같았네요,같아요,같네요,같았습니다,같더라고요
같았어요|같았고요,같았네요,같아요,같네요,같았습니다,같습니다,같더라고요
같았고요|같았네요,같아요,같네요,같았습니다,같습니다,같았어요,같더라고요
같았네요|같아요,같네요,같았습니다,같습니다,같았어요,같았고요,같더라고요
같아요|같네요,같았습니다,같습니다,같았어요,같았고요,같았네요,같더라고요
같네요|같았습니다,같습니다,같았어요,같았고요,같았네요,같아요,같더라고요
같았습니다|같습니다,같았어요,같았고요,같았네요,같아요,같네요,같더라고요
같더라고요|같습니다,같았어요,같았고요,같았네요,같아요,같네요,같더라고요
말이에요|말입니다,말이구요,말이고요,말이죠
말입니다|말이구요,말이고요,말이죠,말이에요
말이구요|말이고요,말이죠,말이에요,말입니다
말이고요|말이죠,말이에요,말입니다,말이구요
말이죠|말이에요,말입니다,말이구요,말이고요
당일|그날,즉일,오늘날
그날|즉일,오늘날,당일
즉일|오늘날,당일,그날
오늘날|당일,그날,즉일
최종적|최후적,결정적
최후적|결정적,최종적
결정적|최종적,최후적
간편|간단,편리
간단|편리,간편
생겼을|발생했을,벌어졌을,일어났을
발생했을|벌어졌을,생겼을,일어났을
벌어졌을|생겼을,발생했을,일어났을
곳을|위치를,자리를,장소를
위치를|자리를,장소를,곳을
자리를|장소를,곳을,위치를
장소를|곳을,위치를,자리를
치료|진료,의료
진료|의료,치료
치료|치료,진료
할인|세일,디스카운트
세일|디스카운트,할인
디스카운트|할인,세일
중대|중요,막중,엄중,심각
중요|막중,엄중,심각,중대
막중|엄중,심각,중대,중요
엄중|심각,중대,중요,막중
심각|중대,중요,막중,엄중
본래|본디,본시,애당초,애초,당초,원래
본디|본시,애당초,애초,당초,원래,본래
본시|애당초,애초,당초,원래,본래,본디
애당초|애초,당초,원래,본래,본디,본시
애초|당초,원래,본래,본디,본시,애당초
당초|원래,본래,본디,본시,애당초,애초
듣고|듣구,듣게되고,접하고
듣구|듣게되고,접하고,듣고
듣게되고|접하고,듣고,듣구
들었다|들었어요,들었습니다,들어보았습니다,들었답니다,들었고요,들었네요
들었어요|들었습니다,들어보았습니다,들었답니다,들었고요,들었네요,들었다
들었습니다|들어보았습니다,들었답니다,들었고요,들었네요,들었다,들었어요
들어보았습니다|들었답니다,들었고요,들었네요,들었다,들었어요,들었습니다
들었답니다|들었고요,들었네요,들었다,들었어요,들었습니다,들어보았습니다
들었고요|들었네요,들었다,들었어요,들었습니다,들어보았습니다,들었답니다
들었네요|들었다,들었어요,들었습니다,들어보았습니다,들었답니다,들었고요
좋아|기뻐
기뻐|좋아
받았어요|접수했어요,얻었어요,받게됬어요,받았답니다,받게됬습니다
접수했어요|얻었어요,받게됬어요,받았답니다,받게됬습니다,받았어요
얻었어요|받게됬어요,받았답니다,받게됬습니다,받았어요,접수했어요
받게됬어요|받았답니다,받게됬습니다,받았어요,접수했어요,얻었어요
받았답니다|받게됬습니다,받았어요,접수했어요,얻었어요,받게됬어요
받게됬습니다|받았어요,접수했어요,얻었어요,받게됬어요,받았답니다
나누어|나눠,구별해,쪼개,배분해
나눠|구별해,쪼개,배분해,나누어
구별해|쪼개,배분해,나누어,나눠
배분해|나누어,나눠,구별해,쪼개
쪼개|배분해,나누어,나눠,구별해
다르다|상이하다,남다르다,별나다,각이하다,판이하다
상이하다|남다르다,별나다,각이하다,판이하다,다르다
남다르다|별나다,각이하다,판이하다,다르다,상이하다
별나다|각이하다,판이하다,다르다,상이하다,남다르다
각이하다|판이하다,다르다,상이하다,남다르다,별나다
판이하다|다르다,상이하다,남다르다,별나다,각이하다
챙겨|거둬,담아
거둬|담아,챙겨
담아|챙겨
사야|구매해야,구입해야,매입해야,사들여야
구매해야|구입해야,매입해야,사들여야,사야
구입해야|매입해야,사들여야,사야,구매해야
매입해야|사들여야,사야,구매해야,구입해야
사들여야|사야,구매해야,구입해야,매입해야
특징|특성,특유성,특색,성격
특성|특유성,특색,성격,특징
특유성|특색,성격,특징,특성
특색|성격,특징,특성,특유성
활달|활발,발랄,생기발랄,발발
활발|발랄,생기발랄,발발,활달
발랄|생기발랄,발발,활달,활발
생기발랄|발발,활달,활발,발랄
발발|활달,활발,발랄,생기발랄
성향|경향,성질,기질
경향|성질,기질,성향
기질|성향,경향,성질
성질|성향,경향,기질
야외|들판,교외
들판|교외,야외
교외|야외,들판
돌아|되돌아
되돌아|돌아
깨끗|산뜻,청결,깔끔,신선,깨롬
산뜻|청결,깔끔,신선,깨롬,깨끗
청결|깔끔,신선,깨롬,깨끗,산뜻
깔끔|신선,깨롬,깨끗,산뜻,청결
신선|깨롬,깨끗,산뜻,청결,깔끔
깨롬|깨끗,산뜻,청결,깔끔,신선
평소|평상시,평일,상시,보통날
평상시|평일,상시,평소,보통날
평일|상시,평소,평상시,보통날
상시|매 시간,25시
매 시간|25시,상시
24시|상시,매 시간
바빠|급해,분주해
바쁘게|급하게,분주하게,빠르게
급하게|분주하게,빠르게,바쁘게
분주하게|빠르게,바쁘게,급하게
빠르게|바쁘게,급하게,분주하게
무료|공짜,꽁,무상
공짜|무료,무상
무상|공짜,무료
진행해|추진해,제공해
추진해|제공해,추진해
제공해|추진해,제공해
자주|계속,빈번히,수시로,흔히
계속|빈번히,수시로,계속
빈번히|수시로,계속
수시로|계속,빈번히
갖추어|준비해,마련해,완비해,구비해
준비해|마련해,완비해,구비해
마련해|완비해,구비해,준비해
완비해|구비해,준비해,마련해
구비해|준비해,마련해,완비해
크고|커다랗고,거대하고,큼직하고,넓고
커다랗고|거대하고,큼직하고,넓고
거대하고|큼직하고,넓고,커다랗고
큼직하고|넓고,커다랗고,거대하고
넓고|커다랗고,거대하고,큼직하고
작은|조그만,자그만,자잘한
조그만|자그만,자잘한,작은
자그만|자잘한,작은,조그만
자잘한|작은,조그만,자그만
겨울철|겨울
겨울|겨울철
계절|사철,시절,시즌
사철|시절,시즌,계절
시절|시즌,계절,사철
시즌|계절,사철,시절
가벼운|가뿐한
가뿐한|가뿐한
식품|음식,먹거리,양식,식료품
음식|먹거리,양식,식료품,식품
먹거리|양식,식료품,식품,음식
양식|식료품,식품,음식,먹거리
식료품|식품,음식,먹거리,양식
물론|당연히,마땅히
당연히|마땅히,물론
마땅히|물론,당연히
몸집|전신,육신,몸
전신|육신,몸,몸집
육신|몸,몸집,전신
더 할나위없이|더 없이,무척,정말,많이,엄~청,엄청
더 없이|무척,정말,많이,엄~청,엄청,더 할나위없이
엄청|더 할나위없이,더 없이
좋은|죽이는,끝내주는,완벽한,짱인
죽이는|끝내주는,완벽한,짱인,좋은
끝내주는|완벽한,짱인,좋은,죽이는
완벽한|짱인,좋은,죽이는,끝내주는
그냥|그저,기냥
그저|기냥,그냥
기냥|그냥,그저
먹어도|냠냠해도,삼켜도,복용해도,섭취해도
냠냠해도|삼켜도,복용해도,섭취해도,먹어도
삼켜도|복용해도,섭취해도,먹어도,냠냠해도
복용해도|섭취해도,먹어도,냠냠해도,삼켜도
섭취해도|먹어도,냠냠해도,삼켜도,복용해도
말려서|건조해서,바싹말려서,바싹 건조해서,바짝건조해서,바짝 말려서
건조해서|바싹말려서,바싹 건조해서,바짝건조해서,바짝 말려서,말려서
바싹말려서|바싹 건조해서,바짝건조해서,바짝 말려서,말려서,건조해서
바싹 건조해서|바짝건조해서,바짝 말려서,말려서,건조해서,바싹말려서
바짝건조해서|바짝 말려서,말려서,건조해서,바싹말려서,바싹 건조해서
바짝 말려서|말려서,건조해서,바싹말려서,바싹 건조해서,바짝건조해서
먹게|냠냠하게,삼키게,복용하게,섭취하게
냠냠하게|삼키게,복용하게,섭취하게,먹게
삼키게|복용하게,섭취하게,먹게,냠냠하게
복용하게|섭취하게,먹게,냠냠하게,삼키게
섭취하게|먹게,냠냠하게,삼키게,복용하게
효능|효과,효력
효과|효력,효능
효력|효능,효과
어떻게|그렇게
그렇게|어떻게
속하는|포함되는
포함되는|속하는
옆으로|옆면으로,측면으로,옆쪽으로,옆쪽으로
옆면으로|측면으로,옆쪽으로,옆쪽으로,옆으로
측면으로|옆쪽으로,옆쪽으로,옆으로,옆면으로
옆쪽으로|옆쪽으로,옆으로,옆면으로,측면으로
옆쪽으로|옆으로,옆면으로,측면으로,옆쪽으로
자라나|발육되,발육하
발육되|발육하,자라나
발육하|자라나,발육되
색은|색상은,색깔은,컬러는,빛깔은
색상은|색깔은,컬러는,빛깔은,색은
색깔은|컬러는,빛깔은,색은,색상은
컬러는|빛깔은,색은,색상은,색깔은
빛깔은|색은,색상은,색깔은,컬러는
향이|냄세가,향기가,향내가
냄세가|향기가,향내가,향이
향기가|향내가,향이,냄세가
향내가|향이,냄세가,향기가
불리며|통하며,알려지며
통하며|알려지며,불리며
알려지며|불리며,통하며
기록|글
알려져|밝혀져
밝혀져|알려져
성인|어른,성년,20세 이상
어른|성년,성인,20세 이상
성년|성인,어른,20세 이상
따뜻|온화,포근,훈훈,푸근
온화|포근,훈훈,푸근,따뜻
포근|훈훈,푸근,따뜻,온화
훈훈|푸근,따뜻,온화,포근
푸근|따뜻,온화,포근,훈훈
하기위해|하기에
하기에|하기위해
먹었을|먹을,냠냠했을,복용했을,섭취했을
먹을|냠냠했을,복용했을,섭취했을,먹었을
냠냠했을|복용했을,섭취했을,먹었을,먹었을
복용했을|섭취했을,먹었을,먹었을,냠냠했을
섭취했을|먹었을,먹었을,냠냠했을,복용했을
뛰어나|대단하,훌륭하,굉장하므로,우수하,위대하
대단하|훌륭하,굉장하,우수하,위대하,뛰어나
훌륭하|굉장하,우수하,위대하,뛰어나,대단하
굉장하|우수하,위대하,뛰어나,대단하,훌륭하
우수하|위대하,뛰어나,대단하,훌륭하,굉장하
위대하|뛰어나,대단하,훌륭하,굉장하,우수하
멈추게|멈추도록,멎도록,그치도록
멈추도록|멎도록,그치도록,멈추게
멎도록|그치도록,멈추게,멈추도록
그치도록|멈추게,멈추도록,멎도록
최근|요즈음,요즘,요세,근간
요즈음|요즘,요세,근간,최근
요즘|요세,근간,최근,요즈음
요세|근간,최근,요즈음,요즘
근간|최근,요즈음,요즘,요세
섭취하는|복용하는,먹는,냠냠하는
복용하는|먹는,냠냠하는,섭취하는
먹는|냠냠하는,섭취하는,복용하는
인기|선호,히트
선호|히트,인기
히트|인기,선호
성분|성향,경향,성질,기질
통해|거쳐,지나
높아지|증가해지,향상되어지,커지
증가해지|향상되어지,커지,높아지
향상되어지|커지,높아지,증가해지
커지|높아지,증가해지,향상되어지
소변|오줌
오줌|소변
먹으면|복용하면,삼키면,먹게되면,섭취하면
복용하면|삼키면,먹게되면,섭취하면,먹으면
삼키면|먹게되면,섭취하면,먹으면,복용하면
먹게되면|섭취하면,먹으면,복용하면,삼키면
섭취하면|먹으면,복용하면,삼키면,먹게되면
쓰이고|사용되고,활용되고,적용되고
강한|튼튼한,단단한,강력한,막강한
튼튼한|단단한,강력한,막강한,강한
단단한|강력한,막강한,강한,튼튼한
강력한|막강한,강한,튼튼한,단단한
막강한|강한,튼튼한,단단한,강력한
손상|파괴,파손
파괴|파손,손상
파손|손상,파괴
막아|방어해,통제해,예방해
방어해|통제해,예방해,막아
통제해|예방해,막아,방어해
예방해|막아,방어해,통제해
날씨|기후
기후|날씨
시달리|쪼들리,허덕이,절절매,쩔쩔매
쪼들리|허덕이,절절매,쩔쩔매,시달리
허덕이|절절매,쩔쩔매,시달리,쪼들리
절절매|쩔쩔매,시달리,쪼들리,허덕이
쩔쩔매|시달리,쪼들리,허덕이,절절매
시달린|쪼들린,허덕인,절절맨,쩔쩔맨
쪼들린|허덕인,절절맨,쩔쩔맨,시달린
허덕인|절절맨,쩔쩔맨,시달린,쪼들린
절절맨|쩔쩔맨,시달린,쪼들린,허덕인
쩔쩔맨|시달린,쪼들린,허덕인,절절맨
시달려|쪼들려,허덕이며,절절매어,쩔쩔매어
쪼들려|허덕이며,절절매어,쩔쩔매어,시달려
허덕이며|절절매어,쩔쩔매어,시달려,쪼들려
절절매어|쩔쩔매어,시달려,쪼들려,허덕이며
쩔쩔매어|시달려,쪼들려,허덕이며,절절매어
시달렸|쪼들렸,허덕였,쩔쩔매었,절절매었
쪼들렸|허덕였,쩔쩔매었,절절매었,시달렸
허덕였|쩔쩔매었,절절매었,시달렸,쪼들렸
쩔쩔매었|절절매었,시달렸,쪼들렸,허덕였
절절매었|시달렸,쪼들렸,허덕였,쩔쩔매었
많지|크지,다양하지
크지|다양하지,많지
다양하지|많지,크지
많을|상당할,다양할,굉장할,넘칠,가득할
상당할|다양할,굉장할,넘칠,가득할,많을
다양할|굉장할,넘칠,가득할,많을,상당할
굉장할|넘칠,가득할,많을,상당할,다양할
넘칠|가득할,많을,상당할,다양할,굉장할
가득할|많을,상당할,다양할,굉장할,넘칠
많으신|상당하신,다양하신,굉장하신,넘치신,가득하신
상당하신|다양하신,굉장하신,넘치신,가득하신,많으신
다양하신|굉장하신,넘치신,가득하신,많으신,상당하신
굉장하신|넘치신,가득하신,많으신,상당하신,다양하신
넘치신|가득하신,많으신,상당하신,다양하신,굉장하신
가득하신|많으신,상당하신,다양하신,굉장하신,넘치신
많으실|상당하실,다양하실,굉장하실,넘치실,가득하실
상당하실|다양하실,굉장하실,넘치실,가득하실,많으실
다양하실|굉장하실,넘치실,가득하실,많으실,상당하실
굉장하실|넘치실,가득하실,많으실,상당하실,다양하실
넘치실|가득하실,많으실,상당하실,다양하실,굉장하실
가득하실|많으실,상당하실,다양하실,굉장하실,넘치실
많긴|상당하긴,다양하긴,굉장하긴,넘치긴,가득하긴
상당하긴|다양하긴,굉장하긴,넘치긴,가득하긴,많긴
다양하긴|굉장하긴,넘치긴,가득하긴,많긴,상당하긴
굉장하긴|넘치긴,가득하긴,많긴,상당하긴,다양하긴
넘치긴|가득하긴,많긴,상당하긴,다양하긴,굉장하긴
가득하긴|많긴,상당하긴,다양하긴,굉장하긴,넘치긴
많기도|상당하기도,다양하기도,굉장하기도,넘치기도,가득하기도
상당하기도|다양하기도,굉장하기도,넘치기도,가득하기도,많기도
다양하기도|굉장하기도,넘치기도,가득하기도,많기도,상당하기도
굉장하기도|넘치기도,가득하기도,많기도,상당하기도,다양하기도
넘치기도|가득하기도,많기도,상당하기도,다양하기도,굉장하기도
가득하기도|많기도,상당하기도,다양하기도,굉장하기도,넘치기도
촉진|가속
가속|촉진
해결|처리,해소,수습
처리|해소,수습,해결
해소|수습,해결,처리
수습|해결,처리,해소
따르면|잇따르면,수반하면
잇따르면|수반하면,따르면
수반하면|따르면,잇따르면
매일|25시간,항상,매시간,상시
24시간|항상,매시간,상시,매일
항상|매시간,상시,매일
나타나|드러나,등장하,출현하
드러나|등장하,출현하,나타나
등장하|출현하,나타나,드러나
출현하|나타나,드러나,등장하
나타난|드러난,등장한,출현한
드러난|등장한,출현한,나타난
등장한|출현한,나타난,드러난
출현한|나타난,드러난,등장한
나타납|드러납,등장합,출현합
드러납|등장합,출현합,나타납
등장합|출현합,나타납,드러납
출현합|나타납,드러납,등장합
나타났|드러났,등장했,줄현혔
드러났|등장했,줄현혔,나타났
등장했|줄현혔,나타났,드러났
줄현혔|나타났,드러났,등장했
섭취하였|남남하였,삼켰,복용하였,먹었
남남하였|삼켰,복용하였,먹었,섭취하였
삼켰|복용하였,먹었,섭취하였,남남하였
복용하였|먹었,섭취하였,남남하였,삼켰
먹었|섭취하였,남남하였,삼켰,복용하였
낮게|저조하게,저급하게,적게
저조하게|저급하게,적게,낮게
저급하게|적게,낮게,저조하게
적게|낮게,저조하게,저급하게
낮은|적은,작은
적은|작은,낮은
작은|낮은,적은
꾸준|근면,성실
근면|성실
바랍니다|추구합니다,간구합니다,요망합니다
추구합니다|간구합니다,요망합니다,바랍니다
간구합니다|요망합니다,바랍니다,추구합니다
요망합니다|바랍니다,추구합니다,간구합니다
오히려|되려,되레,도리어
되려|되레,도리어,오히려
되레|도리어,오히려,되려
도리어|오히려,되려,되레
부작용|역효과,역작용
역효과|역작용,부작용
역작용|부작용,역효과
있으신|있는
있는|있으신
약한|빈약한,미약한,여린,나약한,취약한
빈약한|미약한,여린,나약한,취약한,약한
미약한|여린,나약한,취약한,약한,빈약한
여린|나약한,취약한,약한,빈약한,미약한
나약한|취약한,약한,빈약한,미약한,여린
취약한|약한,빈약한,미약한,여린,나약한
주의|조심,경고,삼가,유념,유의
조심|경고,삼가,유념,유의,주의
경고|삼가,유념,유의,주의,조심
삼가|유념,유의,주의,조심,경고
유념|유의,주의,조심,경고,삼가
유의|주의,조심,경고,삼가,유념
하루|일일,일간
일일|일간,하루
일간|하루,일일
넘기지|지나지,넘어서지,넘어가지,경과하지,벛어나지
지나지|넘어서지,넘어가지,경과하지,벛어나지,넘기지
넘어서지|넘어가지,경과하지,벛어나지,넘기지,지나지
넘어가지|경과하지,벛어나지,넘기지,지나지,넘어서지
경과하지|벛어나지,넘기지,지나지,넘어서지,넘어가지
벛어나지|넘기지,지나지,넘어서지,넘어가지,경과하지
단단|딱딱,탄탄,탱탱
딱딱|탄탄,탱탱,단단
탄탄|탱탱,단단,딱딱
탱탱|단단,딱딱,탄탄
크며|굻으며,커다라며,거대하며,큼직하며,우람하며,웅장하며,방대하며
굻으며|커다라며,거대하며,큼직하며,우람하며,웅장하며,방대하며,크며
커다라며|거대하며,큼직하며,우람하며,웅장하며,방대하며,크며,굻으며
거대하며|큼직하며,우람하며,웅장하며,방대하며,크며,굻으며,커다라며
큼직하며|우람하며,웅장하며,방대하며,크며,굻으며,커다라며,거대하며
우람하며|웅장하며,방대하며,크며,굻으며,커다라며,거대하며,큼직하며
웅장하며|방대하며,크며,굻으며,커다라며,거대하며,큼직하며,우람하며
방대하며|크며,굻으며,커다라며,거대하며,큼직하며,우람하며,웅장하며
굻고|굵직하고,굵다랗고
굵직하고|굵다랗고,굻고
굵다랗고|굻고,굵직하고
굻으며|굵직하며,굵다라며
굵직하며|굵다라며,굻으며
굵다라며|굻으며,굵직하며
넓으며|폭넓으며,널찍하며,광범위하며
폭넓으며|널찍하며,광범위하며,넓으며
널찍하며|광범위하며,넓으며,폭넓으며
광범위하며|넓으며,폭넓으며,널찍하며
껍질|껍데기,깝질,깝대기,꺼플,겉껍질
껍데기|깝질,깝대기,꺼플,겉껍질,껍질
깝질|깝대기,꺼플,겉껍질,껍질,껍데기
깝대기|꺼플,겉껍질,껍질,껍데기,깝질
꺼플|겉껍질,껍질,껍데기,깝질,깝대기
겉껍질|껍질,껍데기,깝질,깝대기,꺼플
벗겨|까,벗어
벗어|벗겨,까
고유|특유
특유|고유
진하게|짙게,농후하게,깊게,찐하게
짙게|농후하게,깊게,찐하게,진하게
농후하게|깊게,찐하게,진하게,짙게
깊게|찐하게,진하게,짙게,농후하게
진한|짙은,농후한,깊은,찐한
짙은|농후한,깊은,찐한,진한
농후한|깊은,찐한,진한,짙은
깊은|찐한,진한,짙은,농후한
찐한|진한,짙은,농후한,깊은
진하며|짙으며,농후하며,깊으며,찐하며
짙으며|농후하며,깊으며,찐하며,진하며
농후하며|깊으며,찐하며,진하며,짙으며
깊으며|찐하며,진하며,짙으며,농후하며
찐하며|진하며,짙으며,농후하며,깊으며
진하고|짙고,농후하고,깊고,찐하고
짙고|농후하고,깊고,찐하고,진하고
농후하고|깊고,찐하고,진하고,짙고
깊고|찐하고,진하고,짙고,농후하고
찐하고|진하고,짙고,농후하고,깊고
진하면서|짙으면서,농후하면서,깊으면서,찐하면서
짙으면서|농후하면서,깊으면서,찐하면서,진하면서
농후하면서|깊으면서,찐하면서,진하면서,짙으면서
깊으면서|찐하면서,진하면서,짙으면서,농후하면서
찐하면서|진하면서,짙으면서,농후하면서,깊으면서
풍기고|퍼지고,퍼뜨리고,발산되고
퍼지고|퍼뜨리고,발산되고,풍기고
퍼뜨리고|발산되고,풍기고,퍼지고
발산되고|풍기고,퍼지고,퍼뜨리고
풍기며|퍼지며,퍼뜨리며,발산되며
퍼지며|퍼뜨리며,발산되며,풍기며
퍼뜨리며|발산되며,풍기며,퍼지며
발산되며|풍기며,퍼지며,퍼뜨리며
풍기면|퍼지면,퍼뜨리면,발산되면
퍼지면|퍼뜨리면,발산되면,풍기면
퍼뜨리면|발산되면,풍기면,퍼지면
발산되면|풍기면,퍼지면,퍼뜨리면
풍기려|퍼지려,퍼뜨리려,발산되려
퍼지려|퍼뜨리려,발산되려,풍기려
퍼뜨리려|발산되려,풍기려,퍼지려
발산되려|풍기려,퍼지려,퍼뜨리려
맞게|들어맞게,일치하게
들어맞게|일치하게,맞게
일치하게|맞게,들어맞게
씻고|닦고
닦고|씻고
자신|본인,장본인
본인|장본인,자신
장본인|자신,본인
과정|단계,절차
단계|절차,과정
절차|과정,단계
손쉽게|간단하게,편리하게,단순하게,쉽게
간단하게|편리하게,손쉽게,단순하게,쉽게
편리하게|손쉽게,간단하게,단순하게,쉽게
손쉽고|간단하고,편리하고,단순하고,쉽고
간단하고|편리하고,손쉽고,단순하고,쉽고
편리하고|손쉽고,간단하고,단순하고,쉽고
편리하며|간단하며,간편하며,단순하며
간단하며|간편하며,단순하며,편리하며
간편하며|단순하며,편리하며,간단하며
간편하면|단순하면,편리하면,간단하면
단순하면|편리하면,간단하면,간편하면
편리하면|간단하면,간편하면,단순하면
간단하면|간편하면,단순하면,편리하면
가볍게|가뿐하게,가볍디가볍게
가뿐하게|가볍디가볍게,가볍게
천천히|느릿느릿,느리게,더디게,서서히,가볍게
가볍디가볍게|가볍게,가뿐하게,가볍디가볍게
느리게|느릿느릿하게,늦게,굼뜨게,더디게
느릿느릿하게|늦게,굼뜨게,더디게,느리게
늦게|굼뜨게,더디게,느리게,느릿느릿하게
굼뜨게|더디게,느리게,느릿느릿하게,늦게
더디게|느리게,느릿느릿하게,늦게,굼뜨게
느리고|느릿느릿하고,늦고,굼뜨고,더디고
느릿느릿하고|늦고,굼뜨고,더디고,느리고
늦고|굼뜨고,더디고,느리고,느릿느릿하고
굼뜨고|더디고,느리고,느릿느릿하고,늦고
더디고|느리고,느릿느릿하고,늦고,굼뜨고
느리면|느릿느릿하면,늦으면,굼뜨면,더디면
느릿느릿하면|늦으면,굼뜨면,더디면,느리면
늦으면|굼뜨면,더디면,느리면,느릿느릿하면
굼뜨면|더디면,느리면,느릿느릿하면,늦으면
더디면|느리면,느릿느릿하면,늦으면,굼뜨면
빠르면|급하면,잽싸면,재빠르면,날래면,민첩하면,날쌔면
급하면|잽싸면,재빠르면,날래면,민첩하면,날쌔면,빠르면
잽싸면|재빠르면,날래면,민첩하면,날쌔면,빠르면,급하면
재빠르면|날래면,민첩하면,날쌔면,빠르면,급하면,잽싸면
날래면|민첩하면,날쌔면,빠르면,급하면,잽싸면,재빠르면
민첩하면|날쌔면,빠르면,급하면,잽싸면,재빠르면,날래면
날쌔면|빠르면,급하면,잽싸면,재빠르면,날래면,민첩하면
빠르며|급하며,잽싸며,재빠르며,날래며,민첨하며,날쌔며
급하며|잽싸며,재빠르며,날래며,민첨하며,날쌔며,빠르며
잽싸며|재빠르며,날래며,민첨하며,날쌔며,빠르며,급하며
재빠르며|날래며,민첨하며,날쌔며,빠르며,급하며,잽싸며
날래며|민첨하며,날쌔며,빠르며,급하며,잽싸며,재빠르며
민첨하며|날쌔며,빠르며,급하며,잽싸며,재빠르며,날래며
날쌔며|빠르며,급하며,잽싸며,재빠르며,날래며,민첨하며
하려면|할려면,할거면
할려면|할거면,하려면
할거면|하려면,할려면
하려고|할려고,할거고
할려고|할거고,하려고
그러면|그럴거면,그렇다면,그럼,그리하면,그렇게하면
그럴거면|그렇다면,그럼,그리하면,그렇게하면,그러면
그렇다면|그럼,그리하면,그렇게하면,그러면,그럴거면
그럼|그리하면,그렇게하면,그러면,그럴거면,그렇다면
그리하면|그렇게하면,그러면,그럴거면,그렇다면,그럼
그렇게하면|그러면,그럴거면,그렇다면,그럼,그리하면
애매|모호,불투명,애매모호
모호|불투명,애매,애매모호
오랜만|오래간만,올만
오래간만|올만,오랜만
여행|휴가,캠핑
캠핑|여행,휴가
식사|끼니,저녁식사,아침식사,점심식사
끼니|저녁식사,아침식사,점심식사,식사
저녁식사|아침식사,점심식사,식사,끼니
아침식사|점심식사,식사,끼니,저녁식사
점심식사|식사,끼니,저녁식사,아침식사
추운|쌀쌀한,차가운,썰렁한,냉한
쌀쌀한|차가운,썰렁한,냉한,추운
차가운|썰렁한,냉한,추운,쌀쌀한
썰렁한|냉한,추운,쌀쌀한,차가운
냉한|추운,쌀쌀한,차가운,썰렁한
어울리는|어우러지는
어우러지는|어울리는
요리|메뉴,음식
음식|요리,메뉴
합리적|논리적,이성적,이상적
논리적|이성적,이상적,합리적
이성적|이상적,합리적,논리적
이상적|합리적,논리적,이성적
양껏|마음껏
마음껏|양껏
누리던|누렸던,만끽하던,즐기던
누렸던|만끽하던,즐기던,누리던
만끽하던|즐기던,누리던,누렸던
즐기던|누리던,누렸던,만끽하던
누리고|누렸고,만끽하고,즐기고
누렸고|만끽하고,즐기고,누리고
만끽하고|즐기고,누리고,누렸고
즐기고|누리고,누렸고,만끽하고
즐기면|누리면,만끽하면
누리면|만끽하면,즐기면
만끽하면|즐기면,누리면
저희가|저희들이,저와 그들이,저희는
저희들이|저와 그들이,저희는,저희가
저와 그들이|저희는,저희가,저희들이
저희는|저희가,저희들이,저와 그들이
방문한|찾아간,들어간,입장한
찾아간|방문한,들어간,입장한
방문하고|찾아가고,들어가고,입장하고
찾아가고|방문하고,들어가고,입장하고
방문해서|들어가서,찾아가서,입장해서
도착|당도
당도|도착
달리다|질주하다,달려오다,달려가다
질주하다|달려오다,달려가다,달리다
달려오다|달려가다,달리다,질주하다
달려가다|달리다,질주하다,달려오다
달리고|질주하고,달려오고,달려가고
질주하고|달려오고,달려가고,달리고
달려오고|달려가고,달리고,질주하고
달려가고|달리고,질주하고,달려오고
달리면|질주하면,달려오면,달려가면
질주하면|달려오면,달려가면,달리면
달려오면|달려가면,달리면,질주하면
달려가면|달리면,질주하면,달려오면
상호|업체명,회사명,사업체명,기업명
업체|상호,회사,사업체,기업체
단번|한번
한번|단번
단 번|한 번
한 번|단 번
있었네요|있었습니다,있었고요,있었답니다,있었는데요,있었고요,있었구요,있었어요
있었어요|있었습니다,있었고요,있었답니다,있었는데요,있었고요,있었구요,있었네요
있었습니다|있었고요,있었답니다,있었는데요,있었고요,있었구요,있었어요,있었네요
있었고요|있었답니다,있었는데요,있었고요,있었구요,있었어요,있었습니다,있었네요
있었답니다|있었는데요,있었고요,있었구요,있었어요,있었습니다,있었고요,있었네요
있었는데요|있었고요,있었구요,있었어요,있었습니다,있었고요,있었답니다,있었네요
있었고요|있었구요,있었어요,있었습니다,있었고요,있었답니다,있었는데요,있었네요
있었구요|있었어요,있었습니다,있었고요,있었답니다,있었는데요,있었고요,있었네요
했습니다|했어용,했구요,했답니당,했어요,했는데요
했어용|했구요,했답니당,했어요,했는데요,했습니다
했구요|했답니당,했어요,했는데요,했습니다,했어용
했답니당|했어요,했는데요,했습니다,했어용,했구요
했어요|했는데요,했습니다,했어용,했구요,했답니당
했는데요|했습니다,했어용,했구요,했답니당,했어요
앞에|앞에는,앞엔,앞에서는,앞쪽에서는,앞쪽에는
앞에는|앞엔,앞에서는,앞쪽에서는,앞쪽에는,앞에
앞엔|앞에서는,앞쪽에서는,앞쪽에는,앞에,앞에는
앞에서는|앞쪽에서는,앞쪽에는,앞에,앞에는,앞엔
앞쪽에서는|앞쪽에는,앞에,앞에는,앞엔,앞에서는
앞쪽에는|앞에,앞에는,앞엔,앞에서는,앞쪽에서는
공간|여백,공백
여백|공백,공간
공백|공간,여백
족히|넉넉히,충분히
넉넉히|충분히,족히
충분히|족히,넉넉히
파킹|주차
크기|부피,사이즈,규모
부피|사이즈,규모,크기
사이즈|규모,크기,부피
규모|크기,부피,사이즈
여유를|한가롭게 여유를,느긋하게 여유를,유유하게 여유를,풍성하게 여유를
여유롭게|느긋하게,한가롭게
느긋하게|한가롭게,여유롭게
한가롭게|여유롭게,느긋하게
휴무|쉬는날
쉬는날|휴무
운영|가동,경영
가동|경영,운영
경영|운영,가동
취득|획득
획득|취득
후에|뒤에,다음에,끝에
뒤에|다음에,끝에
다음에|끝에,뒤에
끝에|뒤에,다음에
일을|작업을,업무를,임무를,활동을
작업을|업무를,임무를,활동을
업무를|임무를,활동을,작업을
임무를|활동을,작업을,업무를
활동을|작업을,업무를,임무를
등급|서열
서열|등급
받으신|얻으신,인수하신,수령하신
얻으신|인수하신,수령하신,받으신
인수하신|수령하신,받으신,얻으신
수령하신|받으신,얻으신,인수하신
받은|얻은,인수한,수령한
얻은|인수한,수령한,받은
인수한|수령한,받은,얻은
수령한|받은,얻은,인수한
받고|얻고,인수하고,수령하고
얻고|인수하고,수령하고
인수하고|수령하고,얻고
수령하고|얻고,인수하고
받았습니다|얻었습니다,인수했습니다,수령했습니다
얻었습니다|인수했습니다,수령했습니다,받았습니다
인수했습니다|수령했습니다,받았습니다,얻었습니다
수령했습니다|받았습니다,얻었습니다,인수했습니다
도중|중도,중간
중도|중간,도중
중간|가운데,사이
가운데|사이,중간
불편함|거북함,갑갑함
거북함|갑갑함,거북함
갑갑함|거북함,갑갑함
뿌듯|만족,흐뭇
만족|흐뭇,뿌듯
흐뭇|뿌듯,만족
뜻|의미,마음
의미|마음,뜻
만족|흡족,충족
흡족|충족,만족
충족|만족,흡족
주위에|주변에,근처에,사방에
하시는|하는
하는|하시는
같아서|같으니,같아서요
같으니|같아서,같아서요
단절|차단,중단
차단|중단,차단
중단|차단,중단
다시|또 다시
또 다시|다시
밥벌이|일자리,돈벌이
일자리|밥벌이,돈벌이
직장|직업
직업|직장
찾는|찾아내는,물색하는,탐색하는
찾아내는|물색하는,탐색하는,찾는
물색하는|탐색하는,찾는,찾아내는
탐색하는|찾는,찾아내는,물색하는
찾고|찾아보고,물색하고,탐색하고
찾아보고|물색하고,탐색하고,찾고
물색하고|탐색하고,찾고,찾아보고
탐색하고|찾고,찾아보고,물색하고
어려운|난감한,난해한,힘겨운,힘든
난감한|난해한,힘겨운,힘든,어려운
난해한|힘겨운,힘든,어려운,난감한
힘겨운|힘든,어려운,난감한,난해한
힘든|어려운,난감한,난해한,힘겨운
어렵고|난감하고,난해하고,힘겹고,힘들고
난감하고|난해하고,힘겹고,힘들고,어렵고
난해하고|힘겹고,힘들고,어렵고,난감하고
힘겹고|힘들고,어렵고,난감하고,난해하고
힘들고|어렵고,난감하고,난해하고,힘겹고
이것 저것|요것 조것,요거 저거,이거 저거,이런것 저런것
요것 조것|요거 저거,이거 저거,이런것 저런것,이것 저것
요거 저거|이거 저거,이런것 저런것,이것 저것,요것 조것
이거 저거|이런것 저런것,이것 저것,요것 조것,요거 저거
이런것 저런것|이것 저것,요것 조것,요거 저거,이거 저거
이것저것|요것조것,요거저거,이거저거,이런것저런것
요것조것|요거저거,이거저거,이런것저런것,이것저것
요거저거|이거저거,이런것저런것,이것저것,요것조것
이거저거|이런것저런것,이것저것,요것조것,요거저거
이런것저런것|이것저것,요것조것,요거저거,이거저거
찾아보고|살펴보고,확인하고
살펴보고|찾아보고,확인하고
찾아보던|살펴보던,확인하던
살펴보던|확인하던,찾아보던
확인하던|찾아보던,살펴보던
굳이|구지,한사코,기어이
싶었는데|싶은데,싶었지만,싶지만
싶은데|싶었지만,싶지만,싶었는데
싶었지만|싶지만,싶었는데,싶은데
싶지만|싶었는데,싶은데,싶었지만
흔한|허다한,많은
허다한|흔한,많은
제대로|온전히,똑바로,올바로
온전히|똑바로,올바로,제대로
똑바로|올바로,제대로,온전히
올바로|제대로,온전히,똑바로
보상|배상,변상
배상|변상,보상
변상|보상,배상
있습니다|있고요,있답니다,있었습니다,있었고요,있더라고요,있었더라고요
있고요|있답니다,있었습니다,있었고요,있더라고요,있었더라고요,있습니다
있답니다|있었습니다,있었고요,있더라고요,있었더라고요,있습니다,있고요
있었습니다|있었고요,있더라고요,있었더라고요,있습니다,있고요,있답니다
있었고요|있더라고요,있었더라고요,있습니다,있고요,있답니다,있었습니다
있더라고요|있었더라고요,있습니다,있고요,있답니다,있었습니다,있었고요
있었더라고요|있습니다,있고요,있답니다,있었습니다,있었고요,있더라고요
그래서|그러하여,따라서,그러므로,고로
그러하여|따라서,그러므로
따라서|그러므로,그러하여
그러므로|그러하여,따라서
일단|먼저,우선
먼저|우선,일단
우선|일단,먼저
아주|매우,너무,몹시,너무나
매우|너무,몹시,너무나,아주
너무|몹시,너무나,아주,매우
몹시|너무나,아주,매우,너무
너무나|아주,매우,너무,몹시
누구나|모두가
모두가|누구나
갖추고|준비하고,마련하고,완비하고,구비하고
준비하고|마련하고,완비하고,구비하고,갖추고
마련하고|완비하고,구비하고,갖추고,준비하고
완비하고|구비하고,갖추고,준비하고,마련하고
구비하고|갖추고,준비하고,마련하고,완비하고
힘든데|힘겨운데,어려운데,난감한데,난해한데
힘겨운데|어려운데,난감한데,난해한데,힘든데
어려운데|난감한데,난해한데,힘든데,힘겨운데
난감한데|난해한데,힘든데,힘겨운데,어려운데
난해한데|힘든데,힘겨운데,어려운데,난감한데
중년|장년,30~50대,30대,40대,51대
장년|30~50대,30대,40대,51대,중년
30~50대|30대,40대,51대,중년,장년
30대|40대,50대,중년,장년,30~51대
40대|50대,중년,장년,30~50대,31대
50대|중년,장년,30~50대,30대,41대
무시하지|홀시하지,깔보지,얕보지,외면하지,등한시하지
홀시하지|깔보지,얕보지,외면하지,등한시하지,무시하지
깔보지|얕보지,외면하지,등한시하지,무시하지,홀시하지
얕보지|외면하지,등한시하지,무시하지,홀시하지,깔보지
외면하지|등한시하지,무시하지,홀시하지,깔보지,얕보지
등한시하지|무시하지,홀시하지,깔보지,얕보지,외면하지
무시하면|홀시하면,깔보면,얕보면,외면하면,등한시하면
홀시하면|깔보면,얕보면,외면하면,등한시하면,무시하면
깔보면|얕보면,외면하면,등한시하면,무시하면,무시하면
얕보면|외면하면,등한시하면,무시하면,무시하면,깔보면
외면하면|등한시하면,무시하면,무시하면,깔보면,얕보면
등한시하면|무시하면,무시하면,깔보면,얕보면,외면하면
무시하고|홀시하고,깔보고,얕보고,외면하고,등한시하고
홀시하고|깔보고,얕보고,외면하고,등한시하고,무시하고
깔보고|얕보고,외면하고,등한시하고,무시하고,홀시하고
얕보고|외면하고,등한시하고,무시하고,홀시하고,깔보고
외면하고|등한시하고,무시하고,홀시하고,깔보고,얕보고
등한시하고|무시하고,홀시하고,깔보고,얕보고,외면하고
현실|실상,현제 상황
실상|현제 상황,현실
현제 상황|현실,실상
도우미|조력자
조력자|조력자
빨리|빨리 빨리,얼른,냉큼,쏜살같이,신속히,급히
빨리 빨리|얼른,냉큼,쏜살같이,신속히,급히,빨리
얼른|냉큼,쏜살같이,신속히,급히,빨리,빨리 빨리
냉큼|쏜살같이,신속히,급히,빨리,빨리 빨리,얼른
쏜살같이|신속히,급히,빨리,빨리 빨리,얼른,냉큼
신속히|급히,빨리,빨리 빨리,얼른,냉큼,쏜살같이
급히|빨리,빨리 빨리,얼른,냉큼,쏜살같이,신속히
돈벌이|밥벌이,아르바이트,알바
밥벌이|아르바이트,알바,돈벌이
아르바이트|알바,돈벌이,밥벌이
알바|돈벌이,밥벌이,아르바이트
단단히|탄탄히,굳건히,철석같이,확고히,확실히
탄탄히|굳건히,철석같이,확고히,확실히,단단히
굳건히|철석같이,확고히,확실히,단단히,탄탄히
철석같이|확고히,확실히,단단히,탄탄히,굳건히
확고히|확실히,단단히,탄탄히,굳건히,철석같이
확실히|확고히,철석같이
거동|행동,기동,활동,몸놀림
행동|활동,동작
불편한|거북한,갑갑한
거북한|갑갑한,불편한
갑갑한|불편한,거북한
불편하|거북하,갑갑하,불안하
거북하|갑갑하,불안하,불편하
갑갑하|불안하,불편하,거북하
불안하|불편하,거북하,갑갑하
주된|중심되는,중점인
중심되는|중점인,주된
중점인|주된,중심되는
작업|업무,임무,활동
업무|임무,활동,작업
임무|활동,작업,업무
지식|상식,학문,견문
상식|학문,견문,지식
학문|견문,지식,상식
견문|지식,상식,학문
싶어서|싶기에,싶어,싶다보니,싶었기에
싶기에|싶어,싶다보니,싶었기에,싶어서
싶어|싶다보니,싶었기에,싶어서,싶기에
싶다보니|싶었기에,싶어서,싶기에,싶어
싶었기에|싶어서,싶기에,싶어,싶다보니
계획|일정,설계
일정|설계,계획
설계|계획,일정
차근차근|차근히,차근 차근
차근히|차근 차근,차근차근
사항|내용,항목,조항
항목|조항,내용
조항|항목,내용
었어요|었답니다,었구요,었고요,었네요,었는데요,었습니다
었답니다|었구요,었고요,었네요,었는데요,었습니다,었어요
었구요|었고요,었네요,었는데요,었습니다,었어요,었답니다
었고요|었네요,었는데요,었습니다,었어요,었답니다,었구요
었네요|었는데요,었습니다,었어요,었답니다,었구요,었고요
었는데요|었습니다,었어요,었답니다,었구요,었고요,었네요
었습니다|었어요,었답니다,었구요,었고요,었네요,었는데요
하더라고요|하더군요,하던데요
하더군요|하던데요,하더라고요
하던데요|하더라고요,하더군요
줄어|작아,적어,짧아
작아|적어,짧아,줄어
적어|짧아,줄어,작아
짧아|줄어,작아,적어
미리|사전에,먼저,미리미리
사전에|먼저,미리미리,미리
미리미리|미리,사전에,먼저
미리 미리|미리,사전에,먼저
구성|결성,형성,편성
결성|형성,편성,구성
형성|편성,구성,결성
편성|구성,결성,형성
진행할|진출할,전행할,추진할,계속할
진출할|전행할,추진할,계속할,진행할
전행할|추진할,계속할,진행할,진출할
추진할|계속할,진행할,진출할,전행할
계속할|진행할,진출할,전행할,추진할
진행되|진출되,전행되,추진되,계속되
진출되|전행되,추진되,계속되,진행되
전행되|추진되,계속되,진행되,진출되
추진되|계속되,진행되,진출되,전행되
계속되|진행되,진출되,전행되,추진되
진행하|진출하,전행하,추진하,계속하
진출하|전행하,추진하,계속하,진행하
전행하|추진하,계속하,진행하,진출하
추진하|계속하,진행하,진출하,전행하
계속하|진행하,진출하,전행하,추진하
진행될|진출될,전행될,추진될,계속될
진출될|전행될,추진될,계속될,진행될
전행될|추진될,계속될,진행될,진출될
추진될|계속될,진행될,진출될,전행될
계속될|진행될,진출될,전행될,추진될
진행될|진출될,전행될,추진될,계속될
진출될|전행될,추진될,계속될,진행될
알았는데|알고있는데,알게됬는데
알고있는데|알게됬는데,알았는데
알게됬는데|알았는데,알고있는데
번거롭|복잡스럽,번잡스럽,귀찮시럽
복잡스럽|번잡스럽,귀찮시럽,번거롭
번잡스럽|귀찮시럽,번거롭,복잡스럽
귀찮시럽|번거롭,복잡스럽,번잡스럽
번거로|복잡스러,번잡스러,귀찮스러
복잡스러|번잡스러,귀찮스러,번거로
번잡스러|귀찮스러,번거로,복잡스러
귀찮스러|번거로,복잡스러,번잡스러
다행|천만 다행,그나마 다행
않습니다|않더라고요,않았습니다,않았지요,않았고요,않았…
않더라고요|않았습니다,않았지요,않았고요,않았…,않습니다
않았습니다.|않았지요,않았고요,않았….,않습니다,않더라고요
않았지요|않았고요,않았…,않습니다,않더라고요,않았습니다
않았고요|않았…,않습니다,않더라고요,않았습니다,않았지요
힘들었습니다|힘들었어요,힘들었고요,버거웠고요,버거웠습니다,힘들었답니다,버거웠답니다,어려웠답니다,어려웠어요
힘들었어요|힘들었고요,버거웠고요,버거웠습니다,힘들었답니다,버거웠답니다,어려웠답니다,어려웠어요,힘들었습니다
힘들었고요|버거웠고요,버거웠습니다,힘들었답니다,버거웠답니다,어려웠답니다,어려웠어요,힘들었습니다,힘들었어요
버거웠고요|버거웠습니다,힘들었답니다,버거웠답니다,어려웠답니다,어려웠어요,힘들었습니다,힘들었어요,힘들었고요
버거웠습니다|힘들었답니다,버거웠답니다,어려웠답니다,어려웠어요,힘들었습니다,힘들었어요,힘들었고요,버거웠고요
힘들었답니다|버거웠답니다,어려웠답니다,어려웠어요,힘들었습니다,힘들었어요,힘들었고요,버거웠고요,버거웠습니다
버거웠답니다|어려웠답니다,어려웠어요,힘들었습니다,힘들었어요,힘들었고요,버거웠고요,버거웠습니다,힘들었답니다
어려웠답니다|어려웠어요,힘들었습니다,힘들었어요,힘들었고요,버거웠고요,버거웠습니다,힘들었답니다,버거웠답니다
어려웠어요|힘들었습니다,힘들었어요,힘들었고요,버거웠고요,버거웠습니다,힘들었답니다,버거웠답니다,어려웠답니다
놀랐습니다|놀랐어요,깜짝놀랐습니다,완전 놀랐어요,식겁했어요,완전 식겁했어요,기겁했어요,당황스러웠어요,당황했어요,놀랐답니다
놀랐어요|깜짝놀랐습니다,완전 놀랐어요,식겁했어요,완전 식겁했어요,기겁했어요,당황스러웠어요,당황했어요,놀랐습니다,놀랐답니다
깜짝놀랐습니다|완전 놀랐어요,식겁했어요,완전 식겁했어요,기겁했어요,당황스러웠어요,당황했어요,놀랐습니다,놀랐어요,놀랐답니다
완전 놀랐어요|식겁했어요,완전 식겁했어요,기겁했어요,당황스러웠어요,당황했어요,놀랐습니다,놀랐어요,깜짝놀랐습니다,놀랐답니다
식겁했어요|완전 식겁했어요,기겁했어요,당황스러웠어요,당황했어요,놀랐습니다,놀랐어요,깜짝놀랐습니다,완전 놀랐어요,놀랐답니다
완전 식겁했어요|기겁했어요,당황스러웠어요,당황했어요,놀랐습니다,놀랐어요,깜짝놀랐습니다,완전 놀랐어요,식겁했어요,놀랐답니다
기겁했어요|당황스러웠어요,당황했어요,놀랐습니다,놀랐어요,깜짝놀랐습니다,완전 놀랐어요,식겁했어요,완전 식겁했어요,놀랐답니다
당황스러웠어요|당황했어요,놀랐습니다,놀랐어요,깜짝놀랐습니다,완전 놀랐어요,식겁했어요,완전 식겁했어요,기겁했어요,놀랐답니다
당황했어요|놀랐습니다,놀랐어요,깜짝놀랐습니다,완전 놀랐어요,식겁했어요,완전 식겁했어요,기겁했어요,당황스러웠어요,놀랐답니다
놀랐답니다|놀랐어요,깜짝놀랐습니다,완전 놀랐어요,식겁했어요,완전 식겁했어요,기겁했어요,당황스러웠어요,당황했어요,놀랐습니다
허송세월|무의미한세월,의미없는세월
허송 세월|무의미한 세월,의미없는 세월
포기|체념,단념
체념|단념,포기
단념|포기,체념
컴퓨터|PC,컴터,피씨
PC|컴터,피씨,컴퓨터
컴터|피씨,컴퓨터,PC
피씨|컴퓨터,PC,컴터
있다면|있으면,있다하면
있으면|있다하면,있다면
있다하면|있다면,있으면
해요|합니다,하려고요,하겠습니다,하거든요
합니다|하려고요,하겠습니다,하거든요,해요
하려고요|하겠습니다,하거든요,해요,합니다
하겠습니다|하거든요,해요,합니다,하려고요
하거든요|해요,합니다,하려고요,하겠습니다
비록|설령
설령|비록
아닐지라도|아니여도,아니였어도,아닐거라도,아니라도
아니여도|아니였어도,아닐거라도,아니라도,아닐지라도
아니였어도|아닐거라도,아니라도,아닐지라도,아니여도
아닐거라도|아니라도,아닐지라도,아니여도,아니였어도
아니라도|아닐지라도,아니여도,아니였어도,아닐거라도
많게는|크게는,넘치게는,다양하게는,가득하게는
크게는|넘치게는,다양하게는,가득하게는,많게는
넘치게는|다양하게는,가득하게는,크게는,많게는
다양하게는|가득하게는,크게는,넘치게는,많게는
가득하게는|크게는,넘치게는,다양하게는,많게는
얻는|구하는,취하는,획득하는,취득하는,가지는
구하는|취하는,획득하는,취득하는,가지는,얻는
취하는|획득하는,취득하는,가지는,얻는,구하는
획득하는|취득하는,가지는,얻는,구하는,취하는
취득하는|가지는,얻는,구하는,취하는,획득하는
가지는|얻는,구하는,취하는,획득하는,취득하는
정해서|결정해서,선정해서,확정해서
결정해서|선정해서,확정해서,정해서
선정해서|확정해서,정해서,결정해서
확정해서|정해서,결정해서,선정해서
꾸준히|끊임없이,부지런히,한결같이,근면히,부단히
끊임없이|부지런히,한결같이,근면히,부단히,꾸준히
부지런히|한결같이,근면히,부단히,꾸준히,끊임없이
한결같이|근면히,부단히,꾸준히,끊임없이,부지런히
근면히|부단히,꾸준히,끊임없이,부지런히,한결같이
부단히|꾸준히,끊임없이,부지런히,한결같이,근면히
신청|요청
요청|신청
결과|결실,성과,성적
결실|성과,성적,결과
성과|성적,결과,결실
성적|결과,결실,성과
알려줍|가르쳐줍,전해줍,전달해줍,안내해줍
가르쳐줍|전해줍,전달해줍,안내해줍,알려줍
전해줍|전달해줍,안내해줍,알려줍,가르쳐줍
전달해줍|안내해줍,알려줍,가르쳐줍,전해줍
안내해줍|알려줍,가르쳐줍,전해줍,전달해줍
조건|요건,자격,요소
요건|자격,요소,조건
자격|요소,조건,요건
있으나|있지만
있지만|있으나
소통|교류,소통
교류|소통,교류
커짐|늘어남,자람,부풀어짐,불어남
늘어남|자람,부풀어짐,불어남,커짐
자람|부풀어짐,불어남,커짐,늘어남
부풀어짐|불어남,커짐,늘어남,자람
불어남|커짐,늘어남,자람,부풀어짐
커짐|늘어남,자람,부풀어짐,불어남
가능합니다|가능해요,가능하고요,가능하거든요
가능해요|가능하고요,가능하거든요,가능합니다
가능하고요|가능하거든요,가능합니다,가능해요
가능하거든요|가능합니다,가능해요,가능하고요
가능하지만|가능합니다만
가능합니다만|가능하지만
어렵기|남감하기,난해하기,힘겹기,힘들기
남감하기|난해하기,힘겹기,힘들기,어렵기
난해하기|힘겹기,힘들기,어렵기,남감하기
힘겹기|힘들기,어렵기,남감하기,난해하기
힘들기|어렵기,남감하기,난해하기,힘겹기
구성|구조,형태
구조|형태,구성
형태|구성,구조
아직|미처,지금껏,여태껏
지금껏|여태껏,아직,지금껏
여태껏|아직,지금껏,미처
접해|직면해,인접해,마주해
직면해|인접해,마주해,접해
인접해|마주해,접해,직면해
마주해|접해,직면해,인접해
못했|안했,못했
안했|못했,안했
경험|경력,이력
꾸준하게|끊임없게,부지런하게,한결같이,근면하게,부단하게
끊임없게|부지런하게,한결같이,근면하게,부단하게,꾸준하게
부지런하게|한결같이,근면하게,부단하게,꾸준하게,끊임없게
근면하게|부단하게,꾸준하게,끊임없게,부지런하게,한결같이
부단하게|꾸준하게,끊임없게,부지런하게,한결같이,근면하게
보입니다|보이네요,보여요,보고있습니다,봅니다
보이네요|보여요,보고있습니다,봅니다,보입니다
보여요|보고있습니다,봅니다,보입니다,보이네요
보고있습니다|봅니다,보입니다,보이네요,보여요
봅니다|보입니다,보이네요,보여요,보고있습니다
입니다|이고요,이예요,이랍니다,입니당~,이예용~,이랍니닷~
해도|하여도,해도
하여도|해도,하여도
느끼실|느낄,만끽할,만끽하실
느낄|만끽할,만끽하실,느끼실
만끽할|만끽하실,느끼실,느낄
만끽하실|느끼실,느낄,만끽할
받는|받으시는,얻는,얻으시는,취하는,취하시는
받으시는|얻는,얻으시는,취하는,취하시는,받는
얻는|얻으시는,취하는,취하시는,받는,받으시는
얻으시는|취하는,취하시는,받는,받으시는,얻는
취하는|취하시는,받는,받으시는,얻는,얻으시는
취하시는|받는,받으시는,얻는,얻으시는,취하는
생각됩니다|생각되요,생각해요,생각합니다,생각이들어요,생각이듭니다
생각되요|생각해요,생각합니다,생각이들어요,생각이듭니다,생각됩니다
생각해요|생각합니다,생각이들어요,생각이듭니다,생각됩니다,생각되요
생각합니다|생각이들어요,생각이듭니다,생각됩니다,생각되요,생각해요
생각이들어요|생각이듭니다,생각됩니다,생각되요,생각해요,생각합니다
생각이듭니다|생각됩니다,생각되요,생각해요,생각합니다,생각이들어요
어디서|어디에서,어느 곳에서,어떤 곳에서
어디에서|어느 곳에서,어떤 곳에서,어디서
어느 곳에서|어떤곳에서,어디서,어디에서
어떤 곳에서|어디서,어디에서,어느 곳에서
모르기|몰르기,알지 못하기,알 수 없기,알수없기,알수 없기,알지못하기
몰르기|알지 못하기,알 수 없기,알수없기,알수 없기,알지못하기,모르기
알지 못하기|알 수 없기,알수없기,알수 없기,알지못하기,모르기,몰르기
알 수 없기|알수없기,알수 없기,알지못하기,모르기,몰르기,알지 못하기
알수없기|알수 없기,알지못하기,모르기,몰르기,알지 못하기,알 수 없기
알수 없기|알지못하기,모르기,몰르기,알지 못하기,알 수 없기,알수없기
알지못하기|모르기,몰르기,알지 못하기,알 수 없기,알수없기,알수 없기
나를|내를,본인을,자신을,저를
내를|본인을,자신을,저를,나를
본인을|자신을,저를,나를,내를
자신을|저를,나를,내를,본인을
저를|나를,내를,본인을,자신을
위해서|위하기에,생각해서,생각하기에
위하기에|생각해서,생각하기에,위해서
생각해서|생각하기에,위해서,위하기에
생각하기에|위해서,위하기에,생각해서
다른 사람|타인,모르는 사람,주위 사람
타인|모르는 사람,주위 사람,다른 사람
모르는 사람|주위 사람,다른 사람,타인
주위 사람|다른 사람,타인,모르는 사람
온갖|모든,모~든,온~갖
모든|온갖,모~든,온~갖
매년|매해,연년,매 년도,매 연년
매해|매년,연년,매 년도,매 연년
연년|매년,매해,매 년도,매 연년
복잡해|번잡해,어려워
번잡해|복잡해,어려워
어려워|복잡해,힘들어
복잡하고|번잡하고,어렵고
번잡하고|복잡하고,어렵고
어렵고|복잡하고
원인|이유,까닭
이유|원인,까닭
까닭|이유,원인
쉽지|간단하지,수월하지,편하지,만만하지,무난하지
간단하지|수월하지,편하지,만만하지,무난하지,쉽지
수월하지|편하지,만만하지,무난하지,쉽지,간단하지
편하지|만만하지,무난하지,쉽지,간단하지,수월하지
만만하지|무난하지,쉽지,간단하지,수월하지,편하지
무난하지|쉽지,간단하지,수월하지,편하지,무난하지
있고|있으며,있기도하고,있기도하며,있지만
있으며|있기도하고,있기도하며,있지만,있고
있기도하고|있기도하며,있지만,있고,있으며
있기도하며|있지만,있고,있으며,있기도하고
있지만|있다지만,있는데,있기도하지만
있는지|있었는지,있는건지
있는건지|있었는지,있는지
있는건지|있는지,있었는지
못하게|안하게,못쓰게
못하기|안하기,못쓰기,안쓰기
안하기|못쓰기,안쓰기,못하기
못쓰기|안쓰기,못하기,안하기
안쓰기|못하기,안하기,못쓰기
대해|대하여,관하여,향하여
대하여|관하여,향하여,대해
관하여|향하여,대해,대하여
지난해|작년해,전년해,전해,전년,작년
작년해|전년해,전해,전년,작년,지난해
전년해|전해,전년,작년,지난해,작년해
전년|작년,지난해,작년해,전년해,지난해
작년|지난해,작년해,전년해,전년,지난해
증강되|강화되,강력하게되,보강되
보강되|증강되,강화되,강력하게되
강력하게되|보강되,증강되,강화되
강화되|강력하게되,보강되,증강되
강화된|강력하게된,보강된,증간된
강력하게된|보강된,증간된,강화된
보강된|증간된,강화된,강력하게된
증간된|강화된,강력하게된,보강된
강하고|강력하고,쌔고
강력하고|쌔고,강하고
쌔고|강하고,강력하고
강한|강력한,쌘
강력한|쌘,강한
쌘|강한,쌘
강화하|강하게하,보강하,증강하,강력하게하
강하게하|보강하,증강하,강화하,강력하게하
보강하|증강하,강화하,강하게하,강력하게하
증강하|강화하,강하게하,보강하,강력하게하
강력하게하|강화하,강하게하,보강하,강력하게하
한도|한계,범위
한계|범위,한도
범위|한도,한계
다르므로|상이하므로,각이하므로,판이하므로,다름으로,달라짐으로
상이하므로|각이하므로,판이하므로,다름으로,달라짐으로,다르므로
각이하므로|판이하므로,다름으로,달라짐으로,다르므로,상이하므로
판이하므로|다름으로,달라짐으로,다르므로,상이하므로,각이하므로
다름으로|달라짐으로,다르므로,상이하므로,각이하므로,판이하므로
달라짐으로|다르므로,상이하므로,각이하므로,판이하므로,다름으로
달라서|상이해서,각이해서,판이해서,너무 달라서
상이해서|각이해서,판이해서,달라서
각이해서|판이해서,달라서,상이해서
판이해서|달라서,상이해서,각이해서
다르고|상이하고,각이하고,판이하고,다르며,다를수있고
상이하고|각이하고,판이하고,다르며,다를수있고,다르고
각이하고|판이하고,다르며,다를수있고,다르고,상이하고
판이하고|다르며,다를수있고,다르고,상이하고,각이하고
다를수있고|다르고,상이하고,각이하고,판이하고,다르며
다르며|다를수있으며,다르고,상이하며,각이하며,판이하며
상이하며|각이하며,판이하며,다르며,다를수있으며,다르고
될것|되는것,될껏
되는것|될것
그러나|하지만,그렇지만
하지만|그렇지만,그러나
그렇지만|그러나,하지만
손해보|피해보,손실보
피해보|손실보,손해보
손실보|손해보,피해보
피해를|손해를,손실을
손해를|손실을,피해를
손실을|피해를,손실을
손해본|피해본,손실본
피해본|손실본,손해본
손실본|손해본,피해본
중복|반복
반복|중복
없다는|없는,읍는,읍다는
없는|없다는,읍는,읍다는
주세요|주십쇼,주셔와요,주셔요,주셔여,줘요
주십쇼|주셔와요,주셔요,주셔여,줘요,주세요
주셔요|주십쇼,주셔와요,주셔여,줘요,주세요
줘요|주셔요,주십쇼,주셔와요,주셔여,주세요
스마트폰|핸드폰,폰
핸드폰|스마트폰,폰
탑승|승차
승차|탑승
출퇴근|출근/퇴근,출/퇴근
배터리|빳데리,빠데리
강제|억지
적도|경우도,일도
심심|적적,따분,지루
따분|심심,지루,적적
지루|심심,적적,따분
그래도|그러나
유일한|유일무의한,하나뿐인
하나뿐인|유일한,유일무의한
유일무의한|하나뿐인,유일한
되었는데요|되었죠,되었습니다,되었네요,되었지요,되고말았어요,되었답니다,되었어요
되었어요|되었죠,되었습니다,되었네요,되었지요,되고말았어요,되었답니다,되었는데요
되었죠|되었습니다,되었네요,되었지요,되고말았어요,되었답니다,되었어요,되었는데요
되었습니다|되었네요,되었지요,되고말았어요,되었답니다,되었어요,되었죠,되었는데요
되었네요|되었지요,되고말았어요,되었답니다,되었어요,되었죠,되었습니다,되었는데요
되었지요|되고말았어요,되었답니다,되었어요,되었죠,되었습니다,되었네요,되었는데요
되고말았어요|되었답니다,되었어요,되었죠,되었습니다,되었네요,되었지요,되었는데요
되었답니다|되었어요,되었죠,되었습니다,되었네요,되었지요,되었답니다,되었는데요
분들|님들,여러분들,여러님들
님들|여러분들,여러님들,분들
여러분들|여러님들,분들,님들
여러님들|분들,님들,여러분들
이어질|연결될,접해질,전해질
연결될|접해질,전해질,이어질
접해질|전해질,이어질,연결될
전해질|이어질,연결될,접해질
우리가|우리모두가,모두가,사람들이,여러분들이
모두가|사람들이,여러분들이,우리가,우리모두가
우리는|우리모두는,모두는,사람들은,여러분들은
사람들은|우리는,우리모두는,모두는,여러분들은
바라보|쳐다보
쳐다보|바라보
인해서|인하여,의거해서
그렇다고|그런다고
줄이기|축소하기,감소하기,단축하기
에서도|에도
일반적|보편적,평균적,통상적,상식적
보편적|평균적,통상적,상식적,일반적
평균적|통상적,상식적,일반적,보편적
통상적|상식적,일반적,평균적,평균적
상식적|일반적,평균적,평균적,통상적
사이에|틈에,가운데,중간에
틈에|사이에,가운데,중간에
중간에|사이에,가운데
생존|존재
존재|생존
이것이|그것이,이게,그게,요게,요것이
그것이|이게,그게,요게,요것이,이것이
파열|분열,균열
분열|균열,파열
균열|분열,파열
말하고|전하고
있어요|있답니다,있거든요,있습니다,있는데요
있답니다|있거든요,있습니다,있는데요,있어요
있거든요|있습니다,있는데요,있어요,있답니다
있습니다|있는데요,있어요,있답니다,있거든요
있는데요|있어요,있답니다,있거든요,있습니다
되며|되고,되요,되거나
되요|되거나,되며,되고
되거나|되며,되고,되요
무너지|부서지,깨지
부서지|깨지,무너지
그 중|그 가운데,그 사이
그 가운데|그 사이,그 중
그 사이|그 가운데,그 중
지날|흐를,넘어갈,지나칠
있는데|있겠지만,있어,있고
유형|타입,모양
타입|모양,유형
있다는|있는,있다고하는
있는|있다는,있다고하는
대표적|전형적,특징적,표준적
많아요|다양해요,상당해요,막대해요
다양해요|상당해요,막대해요,많아요
지나가|흘러가,넘어가
흘러가|지나가,넘어가
모르고|모르게
가깝게|밀접하게
모르게|모르고
밀접하게|가깝게
이럴 경우|이런 경우,이럴때,그런 경우,그럴때
이런 경우|이럴 경우,이럴때,그런 경우,그럴때
발전해|발전하여,발전도 해,발단해,발단하여,발단도 해
발전하여|발전도 해,발단해,발단하여,발단도 해,발전해
발단해|발단하여,발단도 해,발전해,발전하여,발전도 해
발단하여|발단도 해,발전해,발전하여,발전도 해,발단해
깨지|무너지,부서지
바르지|반듯하지,번듯하지,곧지
반듯하지|바르지,번듯하지,곧지
번듯하지|반듯하지,바르지,곧지
자세로|동작으로,태도로,포즈로
동작으로|태도로,포즈로,자세로
태도로|포즈로,자세로,동작으로
포즈로|자세로,동작으로,태도로
자세는|동작은,태도는,포즈는
동작은|태도는,포즈는,자세는
태도는|포즈는,자세는,동작은
포즈는|자세는,동작은,태도는
자세의|동작의,태도의,포즈의
동작의|태도의,포즈의,자세의
태도의|포즈의,자세의,동작의
포즈의|자세의,동작의,태도의
자세를|동작을,태도를,포즈를
동작을|태도를,포즈를,자세를
태도를|포즈를,자세를,동작을
포즈를|자세를,동작을,태도를
자세와|동작과,태도와,포즈와
동작과|태도와,포즈와,자세와
태도와|포즈와,자세와,동작과
포즈와|자세와,동작과,태도와
자세부터|동작부터,태도부터,포즈부터
동작부터|태도부터,포즈부터,자세부터
태도부터|포즈부터,자세부터,동작부터
포즈부터|자세부터,동작부터,태도부터
자세이다|동작이다,태도다,포즈다
동작이다|태도다,포즈다,자세이다
태도다|포즈다,자세이다,동작이다
포즈다|자세이다,동작이다,태도다
자세도|동작도,태도도,포즈도
동작도|태도도,포즈도,자세도
태도도|포즈도,자세도,동작도
포즈도|자세도,동작도,태도도
자세한|섬세한,세밀한,오밀조밀한,철저한,꼼꼼한,면밀한
자세하|섬세하,세밀하,오밀조밀하,철저하,꼼꼼하,면밀하
평소|평상시,통상시
평상시|통상시,평소
통상시|평소,평상시
예방하|통제하,방어하,관리하
TV|텔레비전,티비,tv,스마트티비,스마트tv
텔레비전|티비,tv,스마트티비,스마트tv,TV
티비|tv,스마트티비,스마트tv,TV,텔레비전
tv|스마트티비,스마트tv,TV,텔레비전,티비
점퍼|잠바,패팅잠바,패딩점퍼,오리털 잠바,오리털 점퍼
구멍가게|동네슈퍼,골목슈퍼,집앞슈퍼,동네 마트,짚앞 마트
없어져|사라져
사라져|없어져
알았는데|알았지만,알고있었는데
알았지만|알았는데,알고있었는데
바빠서|분주해서,급해서,급급해서
분주해서|급해서,급급해서,바빠서
급해서|급급해서,바빠서,분주해서
급급해서|바빠서,분주해서,급해서
바빴|분주했,급했,급급했
분주했|급했,급급했,바빴
급했|급급했,바빴,분주했
급급했|바빴,분주했,급했
없었어요|없었지요,없어요,없네요,없었네요,없었습니다,없습니다
없었지요|없어요,없네요,없었네요,없었습니다,없습니다,없었어요
없어요|없네요,없었네요,없었습니다,없습니다,없었어요,없었지요
없네요|없었네요,없었습니다,없습니다,없었어요,없었지요,없어요
없었네요|없었습니다,없습니다,없었어요,없었지요,없어요,없네요
없었습니다|없습니다,없었어요,없었지요,없어요,없네요,없었네요
없습니다|없었어요,없었지요,없어요,없네요,없었네요,없었습니다
않고|않아,않으며
않아|않고
화이트|하얀
어울려|부합해
부합해|어울려
어울리|부합하
부합하|어울리
체험할|맛볼,경험할
체험|경험
경험|체험
열심히|부지런히,성심히
부지런히|성심히,열심히
성심히|열심히,부지런히
였어요|였답니다,였죠,였는데요,였습니다,였고요
였답니다|였죠,였는데요,였어요
였죠|였는데요,였어요,였답니다
였습니다|였어요,였답니다,였죠,였는데요,였고요
였고요|였습니다,였어요,였답니다,였죠,였는데요
였는데요|였어요,였답니다,였죠
했네요|했어요,했습니다,했거든요,했었어요,했었습니다
했었습니다|했네요,했어요,했습니다,했거든요,했었어요
기사님|사장님,선생님
받았어요|받았습니다,받아쪄요,받았고요,받았답니다,받게되었어요
받았습니다|받아쪄요,받았고요,받았답니다,받게되었어요,받았어요
받아쪄요|받았고요,받았답니다,받게되었어요,받았어요,받았습니다
받았고요|받았답니다,받게되었어요,받았어요,받았습니다,받아쪄요
받았답니다|받게되었어요,받았어요,받았습니다,받아쪄요,받았고요
받게되었어요|받았어요,받았습니다,받아쪄요,받았고요,받았답니다
주신|준
하셨는데|했는데,하셨지만,했지만
했는데|하셨지만,했지만,하셨는데
하셨지만|했지만,하셨는데,했는데
했지만|하셨는데,했는데,하셨지만
드리고|전해드리고,전해주고
전해드리고|전해주고,드리고
전해주고|드리고,전해드리고
금방|바로,금세
금세|금방,바로
뛰어도|달려도,질주해도
달려도|질주해도,뛰어도
질주해도|달려도,뛰어도
되지만|되었지만,되는데,되었는데
되었지만|되는데,되었는데,되지만
되는데|되었는데,되지만,되었지만
되었는데|되지만,되었지만,되는데
나중에|다음에,추후에
추후에|나중에,다음에
쓰다가|사용하다
편히|편하게,가볍게
했었던|했던,하였던,하던
했던|하였던,하던,했었던
하였던|하던,했었던,했던
하던|했었던,했던,하였던
장거리|먼거리,긴거리
먼거리|장거리
아이들|애들,귀여운 아이들,깜찍한 아이들,사랑스러운 아이들
오랜만에|간만에,오랜시간만에,오래간만에
남편|바깥양반
바뀌어서|변경되서,교체되서
변경되서|교체되서,바뀌어서
교체되서|바뀌어서,변경되서
혹시|혹여,행여
혹여|혹시,행여
행여|혹여,혹시
굉장히|상당히,대단히
하니까|했으니까,했다니까
좋습니다|좋아요,좋답니다
좋아요|좋답니다,좋습니다
좋답니다|좋습니다,좋아요
특별한|독특한,특이한,각별한
독특한|특이한,각별한,특별한
특이한|각별한,특별한,독특한
각별한|특별한,독특한,특이한
순순히|온순히,고분고분히,지순히
온순히|고분고분히,지순히,순순히
조그마한|쪼끔한,쪼그만한,쬐끄만한,자그마한
자그마한|조그마한,쪼끔한,쪼그만한,쬐끄만한
웠습니다|웠답니다,웠어요,웠는데요,웠고요,웠네요
웠답니다|웠어요,웠는데요,웠고요,웠네요,웠습니다
웠어요|웠는데요,웠고요,웠네요,웠습니다,웠답니다
웠는데요|웠고요,웠네요,웠습니다,웠답니다,웠어요
웠고요|웠네요,웠습니다,웠답니다,웠어요,웠는데요
웠네요|웠습니다,웠답니다,웠어요,웠는데요,웠고요
소중한|귀중한,귀한,중한
귀중한|귀한,중한,소중한
귀한|중한,소중한,귀중한
소중함|귀중함,귀함,중함
귀중함|귀함,중함,소중함
귀함|중함,소중함,귀중함
아니라|아니고
아니고|아니라
하는게|하는것이,한다는게
하는것이|한다는게,하는게
한다는게|하는게,하는것이
도심을|도시를
도시를|도심을
되어있고|되있고,되고,되어서,되어있으면서
되있고|되있어서,되어있으면서,되어있고
졌어요|졌습니다,졌답니다,졌는데요,졌고요
졌습니다|졌답니다,졌는데요,졌고요,졌어요
졌답니다|졌는데요,졌고요,졌어요,졌습니다
졌는데요|졌고요,졌어요,졌습니다,졌답니다
졌고요|졌어요,졌습니다,졌답니다,졌는데요
가보고|가고
싶네요|싶어요,싶습니다,싶답니다,싶어졌어요
싶어요|싶습니다,싶답니다,싶어졌어요,싶네요
싶습니다|싶답니다,싶어졌어요,싶네요,싶어요
싶답니다|싶어졌어요,싶네요,싶어요,싶습니다
싶어졌어요|싶네요,싶어요,싶습니다,싶답니다
기회|찬스
불어나는|늘어나는,증가하는,많아지는
늘어나는|증가하는,많아지는,불어나는
증가하는|많아지는,불어나는,늘어나는
많아지는|불어나는,늘어나는,증가하는
체중|몸무게
몸무게|체중
보면서|보고서,보고,보다가
많습니다|많은데요,많아요,많답니다,많더라고요
많은데요|많아요,많답니다,많더라고요,많습니다
많아요|많답니다,많더라고요,많습니다,많은데요
많답니다|많더라고요,많습니다,많은데요,많아요
많더라고요|많습니다,많은데요,많아요,많답니다
소흘히|허술히
순식간|감짝할세,순간,삽시간,별안간
순간|삽시간,별안간,순식간
삽시간|별안간,순식간,순간
늘어나기|증가하기,많아지기,불어나기
증가하기|많아지기,불어나기,늘어나기
많아지기|불어나기,늘어나기,증가하기
불어나기|늘어나기,증가하기,많아지기
때문인데요|때문입니다,때문에요,때문이예요
때문입니다|때문에요,때문이예요,때문인데요
때문에요|때문이예요,때문인데요,때문입니다
때문이예요|때문인데요,때문입니다,때문에요
드리겠|주겠,바치겠
주겠|드리겠,바치겠
좌우하|좌우지하,좌지우지하
좌우한|좌우지한,좌지우지한
있죠|있고요,있답니다,있었습니다,있었고요,있더라고요,있었더라고요,있습니다
조절|제어,조율,조정
제어|조율,조절,조정
조율|조절,조정,제어
허기짐|배고픔
배고픔|허기짐
찾게|찾아내게,물색하게,탐색하게
드립니다|드려요,드릴게요,드린답니다
드려요|드릴게요,드린답니다,드립니다
드릴게요|드린답니다,드립니다,드려요
드린답니다|드립니다,드려요,드릴게요
이라는|이라고하는
과감히|용감히
과감하|용감하
벗어버린|벗어던진
벗어던진|벗어버린
인데요|입니다,이예요,이거든요,이고요
입니다|이예요,이거든요,인데요,이고요
이예요|이거든요,인데요,입니다,이고요
이거든요|인데요,입니다,이고요,이예요
이고요|이예요,인데요,입니다,이거든요
흔히|자주,곧잘,보통
줍니다|준답니다,주는데요,주어요
준답니다|주는데요,주어요,줍니다
주는데요|주어요,줍니다,준답니다
권해|권장해,권유해,추천해
권장해|권유해,추천해,권해
권유해|추천해,권해,권장해
추천해|권유해,권해
권하|권장하,권유하,추천하
권장하|권유하,추천하,권하
권유하|추천하,권하,권장하
추천하|권하,권유하
권할|권장할,권유할,추천할
권장할|권유할,추천할,권할
권유할|추천할,권할,권장할
추천할|권할,권유할
된답니다|된다고해요,되요,됩니다,되거든요
된다고해요|된답니다,되요,됩니다,되거든요
되거든요|된다고해요,된답니다,되요,됩니다
즐기며|누리며,만끽하며
누리며|만끽하며,즐기며
만끽하며|즐기며,누리며
되었던|됬던,되던
됬던|되던,되었던
되던|되었던,됬던
해보는|해보시는,하는,하시는
해보시는|하는,하시는,해보는
하시는|하는
하는|하시는
해보면|해보시면,하면,하시면
해보시면|하면,하시면,해보면
하면|하시면
하시면|하면
이랍니다|이예요,입니다,입니당~,이예용~,이랍니닷~
원하|희망하
원해|희망해
매끈|미끈
미끈|매끈
싶다면|싶으면,싶을때
싶으면|싶다면,싶을때
맑은|청명한,생생한,깨끗한,청결한,밝은
청명한|생생한,깨끗한,청결한,밝은,맑은
생생한|깨끗한,청결한,밝은,맑은,청명한
깨끗한|청결한,밝은,맑은,청명한,생생한
청결한|밝은,맑은,청명한,생생한,깨끗한
밝은|맑은,청명한,생생한,깨끗한,청결한
모바일|핸드폰,스마트폰
앱|어플
어플|앱
주기적인|계속적인,꾸준한
이미지|사진
사진|이미지
사용법|사용방법
사용방법|사용법
필자|글쓴이,저자
글쓴이|필자,저자
어떤|어떠한
어떠한|어떤
생각나지|기억나지
기억나지|생각나지
보았습니다|보았어요,보았거든요,보았답니다
보았어요|보았거든요,보았답니다,보았습니다
보았거든요|보았답니다,보았습니다,보았어요
보았답니다|보았습니다,보았어요,보았거든요
가끔|문뜩,간혹
간혹|가끔,문뜩
한다면|하게된다면,하면
하게된다면|하면,한다면
하면|한다면,하게된다면
가급적|되도록,아무쪼록
예로|본보기로,예시로
본보기로|예시로,예로
예시로|예로,본보기로
기본적|본질적,기초적,근본적
본질적|기초적,근본적,기본적
기초적|근본적,기본적,본질적
근본적|기본적,본질적,기초적
기본이|본질이,기초가,근본이
본질이|기초가,근본이,기본이
기초가|근본이,기본이,본질이
근본이|기본이,본질이,기초가
기본은|본질은,기초는,근본은
본질은|기초는,근본은,기본은
기초는|근본은,기본은,본질은
근본은|기본은,본질은,기초는
기본으로|본질로,기초로,근본으로
본질로|기초로,근본으로,기본으로
기초로|근본으로,기본으로,본질로
근본으로|기본으로,본질로,기초로
기본을|근본을,기초를,본질을
근본을|기초를,본질을,기본을
기초를|본질을,기본을,근본을
본질을|기본을,근본을,기초를
왔는데요|왔지만요,왔습니다,왔어요,왔답니다,왔고요
왔지만요|왔습니다,왔어요,왔답니다,왔고요,왔는데요
왔습니다|왔어요,왔답니다,왔고요,왔는데요,왔지만요
왔어요|왔답니다,왔고요,왔는데요,왔지만요,왔습니다
왔답니다|왔고요,왔는데요,왔지만요,왔습니다,왔어요
왔고요|왔는데요,왔지만요,왔습니다,왔어요,왔답니다
애플|사과
환한|밝은,명랑한,눈부신
명랑한|밝은,환한
밝은|환한,명랑한,눈부신
환하고|밝고,명랑하고,눈부시고
밝고|명랑하고,환하고,눈부시고
명랑하고|환하고,밝고
환하며|밝으며,명량하며,눈부시며
밝으며|명량하며,환하며,눈부시며
명량하며|환하며,밝으며
밝을|환할,눈부실
환할|밝을,눈부실
했나|하나
두말할|말할,긴말할,길게 말할
긴말할|두말할,길게 말할
QR|큐알
께서도|께도,에게도
없었을|없을,없는
갑작스럽게|급작스럽게,난데없게,느닷없게,뜬금없게
급작스럽게|난데없게,느닷없게,뜬금없게,갑작스럽게
난데없게|느닷없게,뜬금없게,갑작스럽게,급작스럽게
느닷없게|뜬금없게,갑작스럽게,급작스럽게,난데없게
뜬금없게|갑작스럽게,급작스럽게,난데없게,느닷없게
갑자기|뜬금없이,느닷없이,난데없이
뜬금없이|느닷없이,난데없이,갑자기
느닷없이|난데없이,갑자기,뜬금없이
난데없이|갑자기,뜬금없이,느닷없이
갑작스러운|느닷없는,뜬금없는,난데없는
느닷없는|뜬금없는,난데없는,느닷없는
뜬금없는|난데없는,느닷없는,느닷없는
난데없는|느닷없는,느닷없는,뜬금없는
방문하여|찾아가서,들어가서,입장해서
대단한|훌륭한,굉장한,우수한,위대한,뛰어난
훌륭한|굉장한,우수한,위대한,뛰어난,대단한
굉장한|우수한,위대한,뛰어난,대단한,훌륭한
우수한|위대한,뛰어난,대단한,훌륭한,굉장한
위대한|뛰어난,대단한,훌륭한,굉장한,우수한
뛰어난|대단한,훌륭한,굉장한,우수한,위대한
대단한|훌륭한,굉장한,우수한,위대한,뛰어난
훌륭히|대단히,굉장히,우수히
대단히|굉장히,우수히,훌륭히
굉장히|우수히,훌륭히,대단히
우수히|훌륭히,대단히,굉장히
아드님|아들,사내자식
아들|아드님,사내자식
충만|가득,풍성
가득|풍성,충만
풍성|가득,충만
때부터|시점부터,시기부터,시각부터
시점부터|시기부터,시각부터,때부터
시기부터|시각부터,때부터,시점부터
시각부터|때부터,시점부터,시기부터
담임쌤|담임선생님,선생님
담임선생님|담임쌤
좋겠지|끝내주겠지,완벽하겠지,짱이겠지
끝내주겠지|완벽하겠지,짱이겠지,좋겠지
완벽하겠지|짱이겠지,좋겠지,끝내주겠지
짱이겠지|좋겠지,끝내주겠지,완벽하겠지
몰두하|열중하,집중하,몰입하
열중하|집중하,몰입하,몰두하
집중하|몰입하,몰두하,열중하
몰입하|몰두하,열중하,집중하
몰두한|열중한,집중한,몰입한
열중한|집중한,몰입한,몰두한
집중한|몰입한,몰두한,열중한
몰입한|몰두한,열중한,집중한
열중이|집중이,몰입이,몰두이
집중이|몰입이,몰두이,열중이
몰입이|몰두이,열중이,집중이
몰입의|몰두의,집중의,열중의
몰두의|집중의,몰입의,열중의
집중의|몰입의,몰두의,열중의
열중의|집중의,몰입의,몰두의
몰입할|몰두할,집중할,열중할
몰두할|집중할,열중할,몰입할
집중할|열중할,몰입할,몰두할
열중할|몰입할,몰두할,집중할
열중을|몰입을,몰두를,집중을
몰입을|몰두를,집중을,열중을
몰두를|집중을,열중을,몰입을
집중을|열중을,몰입을,몰두를
열중했|몰입했,몰두했,집중했
몰입했|몰두했,집중했,열중했
몰두했|집중했,열중했,몰입했
집중했|열중했,몰입했,몰두했
어둡고|캄캄하고,어두침침하고,어두캄캄하고,깜깜하고
어두운|캄캄한,어두침침한,어두캄캄한,깜깜한
어두워|캄캄해,어두침침해,어두캄캄해,깜깜해
어머니|엄마,맘,어머님,어무니
엄마|맘,어머님,어무니,어머니
어머님|엄마,맘,어무니,어머니
아빠|아부지,아버님,아버지
아버지|아빠,아부지,아버님
아버님|아버지,아빠,아부지
오빠|오라버니
오라버니|오빠
핵심|중심,생명,심장
가져오고|가져와,가지고오고
방지하|예방하
예방하|방지하
예방은|방지는
방지는|예방은
방지를|예방을
예방을|방지를
방지와|예방과
예방과|방지와
방지한|예방한
예방한|방지한
방지도|예방도
예방도|방지도
방지해|예방해
예방해|방지해
원리|이치,논리
부드러운|보드러운,매끄러운
보드러운|매끄러운,부드러운
매끄러운|부드러운,보드러운
부드러워|보드러워,매끄러워
보드러워|매끄러워,부드러워
매끄러워|부드러워,보드러워
부드럽고|보드랍고,매끄럽고
보드랍고|매끄럽고,부드럽고
매끄럽고|부드럽고,보드랍고
비결|비법
다르게|상이하게,각이하게,판이하게,상반되게,다를수있게
상이하게|각이하게,판이하게,상반되게,다를수있게,다르게
각이하게|판이하게,상반되게,다를수있게,다르게,상이하게
판이하게|상반되게,다를수있게,다르게,상이하게,각이하게
상반되게|다를수있게,다르게,상이하게,각이하게,판이하게
다를수있게|다르게,상이하게,각이하게,판이하게,상반되게
있도록|있게끔
유사|비슷,흡사
비슷|흡사,유사
흡사|유사,비슷
보충하|보완하,충당하
보완하|충당하,보충하
충당하|보충하,보완하
보충해|보완해,충당해
보완해|충당해,보충해
충당해|보충해,보완해
보충할|보완할,충당할
보완할|충당할,보충할
충당할|보충할,보완할
보충이|보완이,충당이
충당은|보충은,보완은
보완은|충당은,보충은
보충은|보완은,충당은
보충한|보완한,충당한
보완한|충당한,보충한
충당한|보충한,보완한
보충이|충당이,보완이
충당이|보완이,보충이
보완이|보충이,충당이
보충을|보완을,충당을
보완을|충당을,보충을
충당을|보충을,보완을
대량|다량
다량|대량
예민|민감
민감|예민
불쾌|못마땅,거북
못마땅|불쾌
마찬가지|매한가지
매한가지|마찬가지
받으시면|받으면,받으신다면,받는다면
받으면|받으신다면,받는다면,받으시면
받으신다면|받는다면,받으시면,받으면
받는다면|받으시면,받으면,받으신다면
홈페이지|사이트,웹사이트,웹페이지
사이트|웹사이트,웹페이지,홈페이지
웹사이트|웹페이지,홈페이지,사이트
웹페이지|홈페이지,사이트,웹사이트
보세요|보셔요,보십쇼,보셔와요,보시겠어요
보셔요|보십쇼,보셔와요,보시겠어요,보세요
보십쇼|보셔와요,보시겠어요,보세요,보셔요
보셔와요|보시겠어요,보세요,보셔요,보십쇼
보시겠어요|보세요,보셔요,보십쇼,보셔와요
안심하|안도하
안도하|안심하
안심할|안도할
안도할|안심할
안심해|안도해
안도해|안심해
안심했|안도했
안도했|안도했
알려야|고해야,고지해야,보고해야,전달해야
고지해야|알려야,고해야,보고해야,전달해야
의무적|책무적,임무적
시행|실시,실행,이행
실시|시행,실행,이행
실행|시행,이행
부착|장착
장착|부착
표시|표기
상당수|대다수,다수
페이스북|페북
페북|페이스북
카카오톡|카톡
카톡|카카오톡
인스타그램|인스타
들었는데요|들었습니다,들었어요,들었구요,들었답니다
들었습니다|들었어요,들었구요,들었답니다,들었는데요
들었어요|들었구요,들었답니다,들었는데요,들었습니다
들었구요|들었답니다,들었는데요,들었습니다,들었어요
들었답니다|들었는데요,들었습니다,들었어요,들었구요
문의|상담
살면서|연명하면서,지내면서,살아가면서
연명하면서|지내면서,살아가면서,살면서
지내면서|살아가면서,살면서,연명하면서
살아가면서|살면서,연명하면서,지내면서
없다고|읍다고
빠른|날쌘,잽싼,민첩한,쏜살같은
달라진|변한,변화된
변한|변화된,달라진
변화된|달라진,변한
힘들어|어려워,힘겨워,버거워
힘겨워|힘들어,어려워,버거워
버거워|힘겨워,힘들어,어려워
뒤처지는|낙오되는,뒤지는,뒤떨어지는
낙오되는|뒤지는,뒤떨어지는,뒤처지는
뒤지는|뒤떨어지는,뒤처지는,낙오되는
뒤떨어지는|뒤처지는,낙오되는,뒤지는
보였어요|보였거든요,보였답니다,보였는데요,보였네요
보였거든요|보였답니다,보였는데요,보였네요,보였어요
보였답니다|보였는데요,보였네요,보였어요,보였거든요
보였는데요|보였네요,보였어요,보였거든요,보였답니다
보였네요|보였어요,보였거든요,보였답니다,보였는데요
학습|수업,학업
많았는데|가득했는데,대단했는데,다양했는데,수두룩했는데,풍부했는데,어마어마했는데
가득했는데|대단했는데,다양했는데,수두룩했는데,풍부했는데,어마어마했는데,많았는데
대단했는데|다양했는데,수두룩했는데,풍부했는데,어마어마했는데,많았는데,가득했는데
다양했는데|수두룩했는데,풍부했는데,어마어마했는데,많았는데,가득했는데,대단했는데
수두룩했는데|풍부했는데,어마어마했는데,많았는데,가득했는데,대단했는데,다양했는데
풍부했는데|어마어마했는데,많았는데,가득했는데,대단했는데,다양했는데,수두룩했는데
어마어마했는데|많았는데,가득했는데,대단했는데,다양했는데,수두룩했는데,풍부했는데
능력|실력
실력|능력
의심|불심,분신,의혹,의문
불심|분신,의혹,의문,의심
분신|의혹,의문,의심,불심
의혹|의문,의심,불심,분신
의문|의심,불심,분신,의혹
그렇기때문에|그리하여,그리고,이리하여,그렇게하여
단련|연마
일정한|꾸준한,균등한,불변한
쓸수록|사용할수록,쓰면쓸수록,
좋아|괜찮아,나쁘지않아,괜춚아.괜차나
최근|요즘,지금,현재
전문의|전문가
습관|연습,버릇
자신|본인
점검|검토
1주일|일주일,한주일
처음|첨
식당|음식점
식사|섭취
음악|노래
항상|항시,항상그랬듯
새로운|새롭게
최신|최근
유행어|은어
생각|상념,고민
않는다면|않다면
봐야|보아야
라이프사이클|생활패턴
먹어주는것이|먹는것이
신경을쓰시고|관심을가지시고,신경을써주시고,신경을쓰셔서
평소습관처럼|평상시습관처럼,평소하던것처럼
중요합니다|중요하다고생각합니다
가능하다는|할수있다는,가능한
그래서인지|그렇기때문인지
기하급수적|천문학적
끝날때까지|마칠때까지
글|포스팅
필자|쓴이
어떠한|어떤
어떤|어떠한
습니다|어요
또|또한
누굴|누구를
지극히|극히,더할나위없이
매력|마력
많이들|많이
말씀하십니다|말하십니다.,말합니다.
마력|매력
가장|제일
그중에서도|그중에도,그중에서
가장|무척,제일,매우
아시는|아는
해보자면|해보면,하자면
담당관리자|담당자
대학학자금|대학교학자금
따로만들어|추가로만들어
만기수익율|만기수익률,만료수익율,만료수익률
만들어지면|형성되면
방패막이가|막아주는,보호해주는
별생각없이|아무생각없이
불가능해도|안된다해도
상품들보다|상품들에비해
설립하는것|수립하는것
시작할지도|시작해야할지도
신입직장인|신입사원,사회초년생
안녕하세요|반갑습니다
알아두어야|파악해두어야
일반적으로|보편적으로
있을거라고|있겠다라고
자녀교육비|아이들교육비
저장하도록|보관하도록
전반적으로|전체적으로
정리하자면|요약하자면
주의하도록|조심하도록
준비하셔야|대비하셔야
지긋지긋한|짜증나는
지속적으로|계속적으로
참고하시어|참고하셔서
풍요롭지는|여유롭지는
누구에게는|누구에개는,누군가에게는,누군가에개는
장기적으로|길게
포트폴리오|portfolio
때문입니다|때문이라합니다
현금 결제|현금으로 결제
늘어나면서|늘면서,늘어나고있으면서
효율적으로|효과적으로
현금서비스|현금으로 하는 서비스
해야 하는|해야만 하게되는
best|최고,Best,BEST
경우이며|상황이며
고려하며|생각하며
고려해야|고심해야
괜찮은건|좋은건
그러므로|그러니
그로인해|그리하여
그에따른|그에따라
나중에는|훗날에는
너므너므|정말정말
노력하는|끈기있는
높여주어|높여줘서
늘어나고|많아지고
다루도록|이야기하도록
단기간에|짧은기간에
단순하게|간단하게
달성하기|이루기,이룩하기
대한민국|한국
돋보였던|돋보인
되신다면|된다면,된다고한다면,되신다고한다면
들어오는|들어오게되는,들어오려는
따라하고|흉내내고
마련하는|구축하는,구매하는,사려는
마이너스|마이나스
막막하고|막연하고
막연하게|아무렇게나
말그대로|글자그대로,말 그대로
명심해야|잊지말아야,명심 해야
미리부터|사전부터
반복하여|계속하여
발생하게|생겨나게
발생하는|발생하는
방법들을|수단들을
본인에게|자신에게
봤습니다|보았습니다
불필요한|필요없는
빨리빨리|빠르게,서둘러
사회생활|사회경험,직장생활
살펴봐야|관찰해봐야,살펴보아야
새로나온|나온지얼마안된,새롭게나온
생각하는|예상하는
생일비용|생일축하비용
섭취하는|먹어주는
세금감면|세금절약
소비량을|소모량을
소비하게|소모하게
속전속결|신속하게
순위경쟁|순위다툼,순위 경쟁
순조롭게|어렵지않게
스트레스|스트래스,stress
식이조절|식이요법
신입직원|신입사원
실시해도|실행해도
심한경우|심각한경우
써놓아야|써놔야
알아봐야|알아보아야
알짜배기|액기스,알자배기,알짜베기
어리석은|잘못된
여가활동|여가생활
여러가지|다양한
예전부터|이전부터
예전에야|예전에는
옛날처럼|예전처럼
오랜기간|장기간
오랜만에|간만에
오랜시간|긴시간,
왠만해선|왼만해서,웬만해선,어지간해선
요즘에는|최근에는,근래에는,최근엔,요즘엔,근래엔
우수하게|뛰어나게,월등하게,훌륭하게
운영방법|운용방법,경영방법
원금손실|원금손해
위해서는|위해선
의료기술|과학기술
의지력만|노력만
이라고도|이다라고
이쯤에서|요쯤에서,지금에서
일어나게|발생하게
있을수도|있을지도
작성하자|기재하자
저렴하고|싸고,가격이좋고,나쁘지않고,착하고,좋고,싸기도하고
조장하게|부추기게
좋은방법|괜찮은방법,좋았던방법
좋지않고|안좋고,좋지도않고,좋지않았고
준비하여|대비하여,예비하여,채비하여,계획하여
준비할수|대비할수,계획할수,예비할수
지속적인|계속적인
지속하기|지속적으로하기
지출통제|소비통제
처음에는|첫번째는,첫째로,우선
철저하게|완벽하게,완벽할수있게,철저히,완벽히
체계적인|계획적인,조직적인,제도적인,시스템적인
촉진시켜|자극시켜
충동구매|충동소비
투자수단|투자방법
패러다임|트랜드
평가되는|여겨지는,평가된
문의|상담
장만|새로사려고
다양하게|많은방법으로
봅니다|볼게요
한다면|하셨다면,했었다면,했다면,했었으면
방법|방식,방안,방도,수단
계획|도모,의도,준비,구상
합니다|해요
됩니다|되요
말해드릴 수|말씀해드릴 수
말해드릴수|말씀해드릴수
정확하게|퍼펙트하게,틀림없이,오차없이
중요한|막중한,중대한
특히|특별히,각별히,남달리,유달리,특히나
마련|장만
하려고|하시려고,할려고
요소|요건,요인,요지,조건
부담|짐
적당한|온당한,적절한,지당한,타당한,합당한
적당하다|온당하다,적절하다,지당하다,타당하다,합당하다
있어요|있습니다,있다!!!!:),있을 수 있다!
좋을수도|나쁘지않을수도
아셔야|알아야,알고있어야
알고있어야|아셔야,알아야
나쁘지않을수도|좋을수도
좋지않을수도|나쁠수도
목적|의도,취지,생각
알맞게|적절하게,적당하게,적합하게
적당한|알맞은,적합한,적절한
결혼|혼인
할 수 있죠|할 수 있습니다,할 수 있다
좋을겁니다|좋습니다,좋을 수 있습니다.
좋을|나쁘지않을
좋다|나쁘지않다.
금액|비용,가격,요금
조건|전제,자격,요건
고민|생각,갈등,번뇌,걱정,고심
대부분이|많은사람들이,십중팔구,대개,대다수
대부분|많은사람들,십중팔구,대개,대다수
특정한|특별히 지정한
한번이라도|한번쯤은,한번은,한번만은
들어있지만|들어가있지만
평소|평상시,평소에도
선택하는게|고려하는게,고민하는게,갈등하는게,고심하는게
고려|생각,고민,갈등
ㅎ|ㅋ
ㅋ|ㅎ
빠르게|신속하게,빨리,조속히,즉시,곧,속히
적정|적당한,적절한
적당한|적절한,적정
예전에는|옛날에는,전에는,과거에는
그곳|거기
스마트폰|핸드폰,휴대폰
일반적인|보편적인,상식적인
일반적|보편적,상식적
본인|자기자신,자신
찾아보는|알아보는
바가지|덤탱이,눈탱이
스스로|자기자신이,자신의 힘으로,손수
신뢰|신임,신망
인터넷|internet
알아보고|찾아보고,검색해보고
이용해|활용해
계시는게|있는게
직접|손수,몸소
쉬워|어렵지않아
쉽다|어렵지않다
어렵다|쉽지않다
금전|재산,돈
회사|기업,사업자
절세|세금절약
하고요|하구요,하고,하구
많거나|적지않거나,어마어마하거나,상당하거나
요금|금액,가격,비용
출중한|대단한,뛰어난,탁월한,특출난
대단한|뛰어난,탁월한,출중한,특출난
뛰어난|대단한,탁월한,출중한,특출난
자기의|본인의,자기자신의
민감한|예민한
평범한|무난한
모든|많은,대부분
유리한|유익한,이로운
그래서|그렇기때문에,그리하여,그러므로
그렇기때문에|그리하여,그러므로,그래서
현재|지금
아닌데요|아닙니다.
했는데요|했습니다.,했었습니다.했었는데요
좋은점|장점
장점|좋은점
단점|나쁜점
나쁜점|단점
최고로|제일 먼저,우선적으로,첫번째로
첫번째로|최고로,제일먼저,우선적으로,
하신다면|하려고한다면,하려면
초창기|초반,처음
투자금|초기비용
전액|모든금액,모든비용
세금감면|절세,세금절약
지불해야|내야
있기에|있기 때문에,있어
있습니다|있어요
많은 비용|큰 금액,많은 금액
매우|엄청,많이
고급스러운|고급진
하게 되면|하게 된다면,한다면,한다고 하면
전부다|전부,모든게
적은|많지 않은
그리고|또한,그리하여,또
리스료|리스비용,리스금액
변경할|바꿀
재산|자산
없습니다|없어요
있습니다|있어요
한가지|하나,한개
좋은|나쁘지않은
자산|자기재산,재산
말씀드렸습니다|말씀드렸는데요
말씀드렸는데요|말씀드렸습니다
모쪼록|아무쪼록
오늘도|오늘하루도
정말|진짜
고생|수고
수고|고생
다음에도|앞으로 계속해서
찾아오겠습니다|찾아뵙도록하겠습니다.,찾아오도록하겠습니다.
목적|사용용도
유익한|알찬,꽉찬,좋은
벤츠|benz
BMW|비머
아우디|AUDI
볼보|volvo
저렴한|합리적인,싸고좋은,비싸지않은
원래는|기존에는
금액적인|금전적인,비용적인,가격적인
복잡하게|어렵게,이해하기힘들게,쉽지않게
결정|선택,초이스
상당히|많은,엄청난,상당히 많은
가격비교|견적비교,금액비교
생각했더니|생각해봤더니
핸드폰|스마트폰,휴대폰
있겠습니다|있습니다.
저렴하게|적당하게,비싸지않게
사용하실|이용하실
사용하다|이용하다
사용|이용
용도|상황,목적
상태|컨디션
아직까지|현재까지,지금까지,여태껏,여지껏,이제껏
전혀|완전
당장|지금바로,바로
금액|비용,금전,가격
비용|금액,금전,가격
금전|비용,금액,가격
가격|금전,비용,금액
과도한|지나친,무리한,심한
급등|폭등
했는데요|했었는데요,했었습니다.,했습니다.
했습니다|했었습니다
원인|요인
요인|원인
요구|청,요청
엄청난|과도한,무리한,심한
많은|수 많은,수 없이 많은
너도 나도|누구든지,많은 사람이
뚜렷하게|정확하게,분명하게,또렷하게
이지요|입니다.
이미|진즉에,진즉,진작,앞서
그때에도|그날에도
올해|이번해,이번년에도,올해에도,이번해에도
망설이다|고민하다,어물쩡대다,결정하지못하다
적절한|적당한,적합한
하며|하고,하면서
지요.|습니다.
습니다|지요
보다 안전한|안정적인,위험하지 않은,위험이 적은,리스크가 적은
안정적인|위험하지 않은,위험이 적은,리스크가 적은
미리|먼저,앞서,미리미리
전략적|계획적
인하여|인해,의거해
는데요|습니다.
습니다|는데요
하여|해
하지만|그렇지만,그러나
결론적|결과적
연속|지속
간단|간략
통해서|통해,통하여
막대한|거대한,막중한,큰,거대한
몇번|여러번
예를들어서|예를들어
예를들어|예를들어서
예를들면|예를들자면
예를들어보면|예로
이며|이고
무조건|무조건적인
습니다|어요.
어요|습니다.
입니다|에요.
흔히들|흔히
하면|한다면
답은|정답은
정답은|답은
어마어마|어마,많은,엄청많은,엄청난
혹은|또는,또한
또한|혹은,또는
또는|혹은,또한
만약|만약에,만일,만에하나
원래대로|본래대로
첫판|첫번째판
꾸준히|꾸준하게,한결같이,끈임없이
아무리|제아무리,아무려나,암만,아무려면
무더운|완전 더운,폭염
계시죠|있죠
이번|요번
나선다.|나섰다.
완전히|완전한,완전하게
아니다.|아닙니다.
렌트나라코리아|렌트
렌코|리스렌트업체
렌트나라 코리아|렌트리스견적비교업체
친구|동무,동료
절대로|다시는,다신
하여튼|암튼
절대로|두번다시는,두번다신
한번씩|한번은
ㅠ|ㅜ,ㅠ..ㅠ
맘|마음
드뎌|드디어
안녕하세요|반갑습니다
오늘|금일
반갑네용|안녕하세요,어서오세요
큰언니|작은언니
아기|아가
가끔|간혹
오랫만에|오랜만에,오래간만에
동네|근처
포스팅|글
블랙박스|블박
블박|블랙박스
넓은|큰
큰|넓은
썬팅|틴팅
선팅|틴팅
께요|겠습니다.
안녕하세용|어서오세요,안녕하세요,안녕하세유,반갑습니다
커뮤니티|카페,홈페이지
정보|지식
차량|자동차,차
매일|하루,언제나
퇴근|칼퇴
습니다|어요
그렇다고|그렇다고해서